00000010011101010000110000100010011010010001000001000000011000000100011110101000000000011001000001110
00001000001001110001101001010001000010010000010011100110010000100101000100101100100100010000001011000
10111111000010011010001100100000001010000100001010110100010010000000010011010000001010001101100001010
00000000111000010010001000001011000000000010101000010010000010110001000110000001010000100110000100100
11100101111100001011000110010000011101100000100110010000000011001100010010001001100100001000000001101
00010000000010000100100000000000000110000000000000010100000010110000000010100110011010000001000000000
10000010000101000100001011100000011010100001000010000000101000010101010010000010000110010000101110010
00010000000001000000000000000100010011111000000101101010001000010011010000101001010111010010001001010
00001010000110010010000100000011000000100010001000011000100000001000000110000000001010010100000001001
10011010100000000000011001010111000100010000000100100001001000001100001010110000000001000001000011101
01001001001000100001000010000010010000010000011000100110000010011010100000000010011100100101000011000
00100100100000001100011110000000011111100001000100001100000111101000010001000011101000101000000000000
00100000010110001000111000000001100000010111001010000000000000000101000001011100000001000101001100010
00001100111010011000000001000000010001100101001010000011100001110001101000010111100000101101000110110
10000101100100011001011000100110001101101010000000011110000000000001001110000000110011000110100011100
10000000000101000100000000000000001001000011000100100110010010000100100001000000100010001100000000000
10100011000010001000101000111100110011000000101000000000001011100001000000010001000010000010111100101
00000001110101000101100100000001000100100000000000100010000110111000100000010010001101000001000011011
00100110010000100000100110100010110001000100001000100100000000100001011000101000010011001000000100011
00010000010001010100100110000000110100100011011100010010100010000000000001010001010000011001010000000
01110011000100001010000010000001111000000011000100011000000000000000010001101000011010011010011000000
10000000100000100010101001101000100000001011101110101100000000000000000010000100010101011001100000000
00101000110110010000001110011100101000111001000100110110011000001101001001010100101001110100010010010
10100000011001000010111110010011100000101000000101000001000100010101011100000010010000000010011000101
00000111101000001000000010000011111010000010100001110100010101010100011000001100000000000011010101011
00010010110001100000000101000010011001010010001000000010000100011100000011000010101100010001001000000
00010100001001000011001010000000000000000001011000000011010010010110000000011000000100110101101100010
00010100000100011001001100000010000000001001110101010000100000011100011000110000000000010000011010010
10110000110011110000010000001001100001010001010011011001000000010110000000000010101110010000001001011
00011001010000110110000000010010011010001001010000100111100001100000000010010010011001010000000100000
00011101010100001001000010110000000001001010100100000001010010100110011001000100000010100000110110011
10000101001101000110000000001000110100110000100000001000101110000011000000000000001001110000010011101
00010001000100101001001010000010000010010101000111001000100010111010001000000010000001001000010110100
00010000010000000000000000011010010011000010001100010000000011000110000101010010000100000101000000000
10101000000001010000001100000001000010101010001000000000100000001110110011000100100111000011000010100
00011011000000010010010100110010100000100000001110000001000001000000000000010011000100100010100010100
00100000100011100010010011010000000101010000000111001010000100101000000100100001110001000001001100010
10000000000001010000010010110001011100000011110001000010000000010010000100000000010011001000000111100
00000011100011100010100100100100010110000100110001000100010010001011000011100000100010000000000001110
00000111000001010000001001001110001110100110010000010100010000001000010011011101010010100010010100001
10110001000000010010111010110111010100010110111000000110000000000110011000000011001100000000100000000
01000101101001101000000111100000111000000000011010000000000000100000111110001101010100000000010011110
00100010010000100010000010001000000010001000001100101011001000000010000000100000011001010010010101010
00000110101000100001010010001101000010010000110100000011011010110001100111101000100101010000100101000
00001001101011000000011011011110001101010010110001001100000000000000000110010101000000101000010001100
10010001000110001000001000000011101000000001000101100000000011100010100100101000010001010000000000101
00110100000100000010000000000000100111000000100100000100100010001010000000000000000100101000000100000
00001010001100010000010000000101001010010001101011001000000100100100000001010001001001010001100000000
00000110010000001000110100000011000100000000101010000100000101011100000000100101000010100000000111010
00001111100000000100001111100000100000010110000000111001100100011001110111010000101000000000100001100
00101110000100100010010110100000110100001001110001001000000100010111010010010000010101001000100111010
00100100100100000000001101010001100000000001000010010010100001100010100000000100000000111001100010001
00110001101000000001011000110101000001000010000100010100100100010000001000100100011100100010110000000
01101100011110010000001000100000100101011100001111100011000010000000001000111000100111000111011000010
00110101000100011010101100011000001011111010000000010000000110001101010101010000000010111011100000100
01011000110000100100001111100011001010010000101000110100100100010000100000110100010010000111000000000
00010001000100100001101100100110010000000000001000000111100001000001010111110111000000010100110001100
10000000010011100100101010010000000010100110101001000000100010100000010101011010101100010001101011000
00100100110000000001101001100111100010010001000000000011000101000000100000110100000010100010001000001
00110100100101001001100111000100110001000000000000000001100000111001001010100000010101101110011010001
01000000000101010001101100001000101000000100101000101010000100100010000011011110000001010010010000001
10010000000011000110000110000000100001100000101000000000111001100100100100000101011010000101100101011
01000100001010011001110010000000000110111010001010000000110000101000000000100000101101100010100100001
11001011100100011100000110000100011100000000001100000001001000010000000001100101111011001001010011101
01000000011001000101000100111010001010000011111000000100010001000101000001000100001010010000001100100
00001100111110100000001001000010000001000001000000100101110001001000000000001000100000000000000000001
11000100100110000001100100000101000000000000000110000001000000111000000011010000100000000100011000101
10010101010000000101111100010001000000111011000110101000000010010000000010110010000011000001011001110
00011111000001100100110011001001101101100101010001000100010010001000000100010110100000000000000010001
10000000001100101000000010110010100000110101000010100001100100100100000000000000010001100100100011100
10000001110100100000110101000000010000010001001110100000100001000001100000000010010000011001100000000
00100010100011000110000001000010001011101110000010111000011101001000100001000100001100000001000001000
10100110011000110100010000010000010000010011000000010000001001000111100010110010010100100100100000011
01111011001000000000000000110001001000011100000000001000000010001111001000000011011000011000001000000
01010001010011000001000010000100100001100100000011000111001100100000100000110000001001100010010000000
00100000010110100001001000110101000000000001000010100100010100001011010101000000111010100110110001110
00110000000110000001010110001001110000011111010000000101100000100000101011100000100000001000001100001
00101010010001100000001000001110100110110000000000001000001000110010000001011110100010110101001000000
00110011000000000011010000000000000011110000101100011001010011010000000001001010001001001001110011100
00110111101000000111000101001000100010011100101000001101000010110010101011101010110000110010101010000
11100010000000000000111000100101001000111000000011000000000000010001010000010010000000011010100010001
10001100001101001100010011100110101010000000010010000000011110000010000000000110001000100011000011110
01001110000001001011100100000001010001000001001000000110101000110100010010010111000010000000100101000
00001011000010001001000110010001011000100110001011000001100010001000010000010010010000101101101000000
10000000000001000010100010000101010001010000000000010000100010100100000110001001101100000000001101110
10101001100100100001100010001000000000000000010100000110001010010001000101011000011001010100101010010
00100110000000100000010000000010010111000100001110000001100011110001100100100000110100010000000110000
00000000001100010000010100000000000000101011100010101000110010010001001011000001110001001100000101000
00000100100100000010010000000010000010010000001000000011011010001101110010110101011111100110000101001
10101001001001000001000100100011000100001000000000011000100000111000001000000001000000000001101001001
00000001110000010000001000010000111001000001000000000010010101000100001000101000100000101010000000001
00010100100001100000001000001001100011000010011100100010111010110100011000101111011011001000001000001
00010000000000110010000010010000000101000101101100110110001000000000110000100001000100110000100001000
00000000011000010010000001101010000010001100000100100000000010000010010101000001001000010100011001101
00010000000000000001001110001010010001100010010001000001101000000010001000000100000000111000000001101
11001100001000000001100000000000110100000010010000010000100100100100000001000010110100100110000000100
11100100011000001000100010001010010011010010000010001110000000100000010000000000100000100001101000100
10100000000000010000000010000000000110001010000000101000000000001011000100001000000000000100011001000
10000000000010110000010000100010010011010100011100100001101010010000010001000000001000001100000100011
00000000100010111000001010000101001001000000000000000000110000010000001111100110100001011110101001000
00000101010100101100010000011001000000010000110100000011000000001001000000000100001100001000010100000
