01001000000001000000000110000100101010100000011101110111111110000111000110100000011001000001010000000
01000000101110011010100010110001000100101001100111100011010000001101110000010000100001111000000010111
10101100010001100001000100001010101000010000000000000100000000000001000001100010100000001010000001000
10000010011000011101101000000001000000111111000011001000001100001010000110110100000110110001000010101
01000100010000001010011100001000001010000001000000010010010010011101000001000100110001101000000000000
10100100000010000001000101001000000101011000000001100111000001100001000000110001001010111000011000010
11001001000111000000001000010001000010011000111110000010110100011000000010000001000001000100001000100
00000000011010010010000101001100101001000000110100000111001010110101010100010000010000100000010000010
00100100001100000000010100010010110101100011011010000100101010000101000001000000010001010110011110010
00010001000000000000100010010000010001110000000010100100011000001000000010000000000010000000001100000
00010001011000000000000100000001000000000011000001101110101010100010000000011000010100010100101000010
00000010000000100000000010100001010010000111011000000000001000001001101000000000000000010111001000000
01010001010011000000001100000100001010010101011000000000010000101110010000000011010111101000000000000
01001000000100100000111001010110001100111100010110100100010000010000101011010000001111010001000100011
00001000011000000001110000000100000100010000000000101000111000110000000010010111000000101000001000101
00001011000010000001101111000000100000011101001000011110100001100000111100000001100000001000000000000
11011110010001100010000000100010000011000100010011100000001000001010111000100000000000000100010000000
00100010011001000110001000001001001000010000100010000010000110010000110000100000010101000000100111000
01100110000001011000001001000001010000110111101010101010010010011000010100100111100000000000000100100
10110100000001000010000000000001000000110000100011000000000111100010100100101100101010001011000100000
10001011101001000101101100000111011101000000110001000000111000000011010110000000010001000110010001001
00000000110110001110100011001000011000000010110100000110010001011000100010001100000000001000101100000
10001100010000000000000100001110000000110100101000000000110000000100010001100000000000110111100100001
00111100110101011011001011100001000010010000010001101000010110000100000100011010101000000011100100010
00011100000001010100000110000000010001010000000001100000001010000001001011000010010101010100110000000
00000001010001001000000011001010111100000000101000010100010011000100000001100010110001010000010010100
00010000000001010001000100111110000000000000000001000101011100000100000000001010001101011100101101100
01000000001001001000100000100011010010001000100001000100000000100001010100000100000000000100101000010
00010000011010000101100100001000010000000000101010000000000000010010010010010000000001000000001100101
10000000000000000000000010001000000111111001000110100011010001101000100000000000010100110100001110000
10010000010010000000001000001100000101000000101000001011000001010000001100000100011100110000000000101
01110001000110001000101111000011000000101000001000001001000001010100100000001000001000011000001000000
01000000000010000001000110001000000110001001000100101010000010000001101101011010011000000000001000010
00100011101100100000011001010000011001011100111101011001010101001000101000000000101000010111110110001
11000001010000000000000100000011011000100000110101000000001000010000000111100100000001010000000100010
00100000010000101100001000001100000010000100010000001011000000000111101010110011010100111000100000010
00001011011000001111110111101001101001011010000000000010001001011111001011100001110000100001011010010
00110010101000000001000000110010001110001000000000010000011000110001110010000011110100010000001000000
00000000000010111001000000111000000010000110100000101000000110001101100101101000110001000000000011000
00000000011000101011001011010000000010000100100011010000000010010000000110010100000100010001000001110
10001000000110000000001100100010011000100001010110001001001000011101010011010101001000001001101000000
01000110001001000000001000000101110000110100001000000000110000011001100010010010000100011100000001110
10001001000001001011100001000000010000011010100010101010100000000000010010100001010000001011000000100
01000000010101100000001000101101100000100101010000011001000100010000000001000000100000010010000100100
00000111010011011011110110000000000010010000000010010000110010100001001000100010001001000011011000001
10010000110000100000100000000000001011001101100100011100000000111001010000000100010000110001010000000
00000100010000000101001100101001011100001101110010010001011111100000000000001011011011010000001000000
10100000001000110000000000100000111000100001000001100000110000000011101001011100010000101110110000000
01011000000001010100001101010101111101010000000001000100000011000000100000100100000000001000100000011
00100110100001100001100000110000001101100011000101100000011101101101101110100101010000101000000011101
00000011000000000010000000000010100000010100100100001000010000100010011101000000001101000011010001000
10001100100100001000111000000001000000111110110001010101110001011100011001000000001010100000011000000
00110111000000000011110000010010000010111000110010100111000000000001000000000110000000000001000010010
01010000000000010100011010000100000110001000000010100100000000000100010110100001000100100010010011110
01001010101010001000010000001000010010011000111000011000110100010001000100110000101100000100001000000
01000101010001001100100001101000000001000000000001010110100010011000000100001010000100000100010001000
00001001000100000000100011001001111010000010001000100000010010110000000011101110101010011110000101000
01000001000101010101100011000100000000010010000000000011001100001000001000010100000100100000000010000
00000101111000010000010001100110001000000000001000001010000010000000110001000101001010011100000010100
00000001101000010101100001000000000000100011000000000100010100100100000111100000100001000011000001001
01000100000110000110100100010000011011000010001010001000100001010100000001001000011000010010000010101
10000001101110110000000001000110010100001000000001000101001111011000011100011001011100101001000110110
10000000101010000101000000000101000101000010000000000101001010001100011100101100000001100000011000001
00001111100000100111001011011000011000011000111000010101001010101001000000010010000101000000001000110
00010000000001000111100001000000100000110101100110100000000000100000011101101101000010100100011010010
00011100001000101000011001000010010100111101000000000011111001000000000110000100000110010101100010100
10000010101000000010000001001011011111100111001001000010000000001000011000001010110001001000011011001
01100010110000000000000111111110000010001000010000101110000011000100001100100010001110110000000100001
10100000000000101110001001100000000000001111010001001000000100010011000010100010100000000010001000000
10100100000100000100111100001100111110000111000010001010101010110101010100000110000010100000001001011
11000000000010010000110011000000010100100001101000000100000000010001000000000011010101011001111010000
00000000000110000001111000000111000100001000010000001001010001000100011000100010100111100010000001000
10001010000100001001000000111000001110010000001001011001001100001111100010100010011010100101001010101
01000001110010000011110010011001100010101011110000110000010000001010101010100010010101000100000010100
00000000100000000000000011101000111100001000000000100000001000001111011000000000000000000011010000001
11001000010100010001011011000110001000111010010010100010010000010001000111011000000000000000101100001
00101000100001000100010000110000110100001001001010011000010000000000010000000000010011011101000000100
10110100000111000011000001100000100000000110100010100100000110011100010000100100001010000000010000011
10000010111010000010000110010100000000010000000001010011111010110100000101000011000001110100000000010
10111001001110010000100100000000000100011001001010000001111010001110001000000101000000000000001011010
00000000001000010011010000000111101100010000001110100100100110100001100100000100101000000100100110010
00100100100000010000000000001011001010100101001100000010010000100000100000010010001010111000000000100
00000100000010000101001011100100101000000110110100001000011001010100000000100000000001000011000111000
00000000010001100100101101001110011100000111000011001100010010000010001001010100000001111010100010000
11001000011011010011011001000110010101010000001110010010100001000000000100001000100010101001000100010
00000100000010010000110000000000000000101101010010000010000100000000011000000100101100000011000100000
00111100010001001010010001000001100001000001111011010001000100010000100001000000001010110100000100001
01001101010001000010000111000010001000000010101000100011110000000000000001011010100000010100000110001
00010001010010001001010110010000000000010011100100000001001001010001101000001100001010000000010011000
01000100110001000010100101100100100101111010000101000110100101000001100000111000000110010000000010001
00011011000000011000011010000000100011000101010000011010010010110000001000000101001011010100100000001
00000001000000101010000000011000111010100000000000110100000000010000000001011000101000100010000000000
11000111000110110001000000110101000011000001101100001111000000000001011110001001000000000000010000001
01000000101110001111110000010000000000000010001101000001011011100000010010100000010001000100100000000
00010000100111000000100000111110001000001110110100010000000001100010000100000001000001100000010000101
00100000000000000000001100101110100110110000000100100000110010010000000000001010000010100111100100001
10100001001100001000101100010110001001000001100000101111001000001011110011010001101011001101000100001
01101001001000001000000100100100000000100001101100100000000001010000010100001000101001000100000111010
00110000010100110000001000000100001000011000000101001010001000101000010011100001001100000001100100001
00011010000001000000000011000001010000000000010000000000010010000001100000100010000110000010010111101
00000100100000000000000000000011001110100111000000100001000000100101100000011101101000010010101101000
