00000000000011000000011010010010100000000000010000001010000001100111101101101000101001101010000011110
01000000111011000000000011000101110000000000000010000000110000100101110000000001000000001000000011010
00000000100101001100110100010101001000010111000000000000010001000000000100110101101000000100000010000
10001000010000101000010001100010000100100101100000100000000010010010110000010100001100001000100011001
00000010101101000000001001001000001000101000010101000100100000010111110100100100000000010010110010100
00101001010000011110100111000000001010011000010000000110001011000000100000000000010000000100100100000
00000001100000100000001100000000110110001001100010001000100001100010000010000010000010000001100100001
00010101101000100001111101000110001000100000100001000010001110000001000000010110110110001100001000001
01000011000010001000010001010000010001001010001000100000000010001100000011001000100110110000100010101
10100011001010010001010110111000100000000011011100000100101000000010100001000010001010000000101001010
01000000110000001100010011000100010101000100110001011101110101100001101001110000110100010100010001000
00110000100001010010100010001110000000001000000001100000000110101101000000001011110000110010000001000
00100111010000010000000000100000001110010001010010000001001100000001110000001010011010101000010000001
01000000000000000000001110000011010000101010000100011110000000100011110001000000101000101100010000010
00001000000001011000000100010000101011000011111010010100010000010010001011001010100100001011001100010
10110001000001000001000100000000101000000110011001100000101000000100100001100000011000010001000010010
10000110001010001011100001010001000000111110000100100101010010001100110010011000110100000110110011000
01010000000000100100001000000001000000100010000010010110000000000001010101000101001001110010000110111
00111110000000100010001001101000010001001000000010010001000000001001000010000011011000000010000100001
11010110010100101100000000100001000001000000000010010010000010000100111100001110010000001000000011100
00000111001000001100011001010000100000000001100100000000000000000100010100100001001000000100000010010
11000001000101010000010100100000000010000000000000010100000010001010101011000001000110100101000001000
00010000000000001000001010100010001000000001000001010101000100000011011011000000100000000111101100000
00001101000000110001110100011000010101001001001000010100011001100111000000000010000100100111000010000
00100111011001100010010000100111011000001100101000100000000000011100010000001000000000001000101100000
00000000000000000110000001000001010111101000011101110010000010101000101110100000100000011100010001100
11000000000010010000010001010101010100110110000000000001011101100100011101000110011011000011000100000
00000100010001000010101000100110000010000001000000000001000110110010010101001110100001001010100101010
00101100001000000000000101101001001100000000000000100000001000001000000000010010001000010100111011011
00000101000100100000011010101100011010000011001000101001100001010000100000011010001100010000101010000
10100001011001000010011000001001000001100001010111000000000001111010000010000100000100000010100100100
01001011101100000000010000001010000001110010010001001101100101010111110000001001011100000000100001010
00000110100001000001110000001000000110010101010011010111011011001010000001000010000000110000010100010
00001000000100100000100000000100100111110101000001000101110001000100101011010000000101100011101000000
10110001010000001001001100000000010100000111010101000000010100001000001100100000010000100000010000001
01010000001000010001001000101101110001100100100000100100101000000110001100000000100101110000000000100
01000010000001100010110001000101101011000000011000101000001100101001011010011000100101010100101000100
00101101000100100010000100000000000110000011111110010001100101000010000000110111100001110111001010101
00000100000011000110011100010001010100010100010010000010010000010000000010100010001101000000001000010
00010001000101101001000100000100100100000100101010000001011000101100001000010101010110100001000100000
11010100000000000000001010000110101010000100000000100001010000000100110100101010110000000110010011000
00010001110000001010010000100001111000001001000100000001111010000001001100000100101000010000101000011
10010100100111100000010011000111100101001000001000011001000110101000110100000001000101000001011010100
01110110000001000101100100000001100000100000110101011011000010010000101001001110000010001001010111001
00000100100000000110101110110000000110010010110101100000011111001000010000110010000000000100011011001
01000110100010000000101010000101001010010010010000000001000010000000000011001010000000000100100100001
10100001101010000100010010011000001111001000101010001000110000000010010000010000100010101100000100010
01001100000100110000000000001010100001010100010101101101100000000010110010000010000100000011000100110
10010110011010000010011011001100000010010000011000100101000110000101000100100000001001010100001100000
10001010000111100100010101011001011010010001010000000010001100000001000010111000000101011100010000101
10000000010011000101010011100001010000111010000011010111100000100010000101000100100010000010110000000
10000100010000110010001111010000010011010100000100100000010010000100011001000000100001010000000001111
10001001001000100101000100001000000100110000110101010000001000001000000010000000000001001000001000000
01101010000101111000100100011000000100110001100101011000000010111000010000000011000110100001000000001
10000101000000010010001001000000100001000101001000011100000100000010000001011011100000100000100010100
01011010000001001000011000001000000110010010010000000000101000000000000000010011001001000000101001110
10110000110010100000101010000010000000001001001011001010110010001100000001100010001000001100000010000
10110001010000001010000100100101000000010000010101110100100001000000000110000010011000000100110100000
00110010010000011001101010000010010111011000001010000011110001101010001000010100110100101010001100011
00010111111010100000000000010010001101101000010001010001001000010000000001000000110001000000000001000
00000011110000110100000000101000010011000000000000010111001000011010010100101110100010010001100011010
10011000000111011011010000101111110000000010010100000000110000101000100010000110000000010001000000000
01100100101100000110110101000100000100000000000100000000001100001010011101000010011011100101011010011
10000011011001100000001100100100000001111010010110010001000101001110000011100001100000111000011101001
01000001100000100001100010000001000001101010000100101100001010000010001000000110000000100101101000010
00101000000010100010000000000100001000001000000100000011000111000011010001010101001011000000100000000
01100000000011001010010000000000010000000010100010000000000110001000010001000100111100011000000000000
01000100010001010000000000000000001110000000000000000000010000001000000100000000010100000000010000001
00000000000001101001001010000001001010000000000100000000001000000100000000000001100000110100001000001
01010000001001100010100010100001001000010001000010000010000010000000100001110010101101001000000110011
01111100001010101011010100111000001101100000000110000010000100000100101000001010001010000000001100001
00001000101100100100000001010110010011010001110000000001000010010000110000000000010000100010100000000
00011110000110010010000100000101000001000100100001000110001010010000000011001000000000111111001110101
01000011100000010000001010101010011010000000000001011001001010110110101000000000000100000010100000000
00000000100010000000111001000100000001000000010001000000010000111001010000000000111100000000101001100
11010101000001100000010000000010010010100010000100000001101100111110011000011101100000100001000110011
01100000000101011101000010000000100000101100010011000111100100101001100110001010010000010010101001010
00101001000010000000010011100001000110000000000110000000001001010000000100101100010001010010000000001
00010001010001000000000110100000010100001111001100000000100000010100001100010100000001000001010011000
00000000010001100000100100001101100011010000001001000011000010000000110000001000000010010000010101100
00010000000011000100000001000011000100100000010000000000000100000101001110100001100000000000000000101
00000010100000001001100000001101011001001001001000110010001001010100010010110100100100000000100110100
10011010000101001000000100000110100001110010001010100000110000110110000011000001100101011110010010001
10100000100000100000100000110000100000000000001010000010100010111100000100100000000111001100101001101
01001000001000001000100000100010000011010000000110001010000000001110011100100100100001010100010101011
00010100100010000010100001011001101000010001100000100101000000110000000110000001100001011011011000000
10101001000001000000000000011000010000001001000001000000011110101101010010110000000100110000000100100
10100001100001010111011000000001000001001000100001101010000001000000101010000000000111010000101100000
10000111111110000001000001010000000010100010001111110000001101001100101000100100000110010011100010000
00000010011000000001000100010000000100000000000000000010000000100010010010000000010100001000111000010
00100000001000010100000000011000000001000000100110100001000001100010011010101110000001001100000010001
10001000100110000011000000100000111100000000010001000111110010000100000110000000001001000000000000100
00011001000000100001001000000010110000000000100000000001001100010000011000000001001110000110001001010
00011000110000101100000111111010100000001100101000001000101011011000011010000000010010100000000010010
10100000000010001000010101010100100000010100001011101011000010001000000000010010001110000010000000101
00000010000110000001001101110010001000000000000000001000101100001000010000000011100000000001000100000
11100001101010000010100000000100011100000001011011100010110110000001100101101000001010000000100000000
00001000000110010000100101101000010001011101110000101000110101001100001001010000000000000001000111000
01000000101010001000110000000000100001100100011100000000101001000000101000101010010011000001000101000
00000100100001000101010001000100111010100001010010000000010001000101000000111110010001000110010010011
01101001000001010101011100011001000000010000101001100100000100000000000010001000000000001000101000000
