01000100110001000010010110101010000000011000111000001110000000101001100100001000001110010000101010000
00100111010101100000001110100000000100101000001001000000011111000010000000010001000110100000101000000
01000100010000000011010000000010000100010011111111010011000010100001101110001000100000001011000100000
00010000000000100001000000000000101000001001000010101101000110010100000000010010100111000100011000000
00110111000010000000100000000001010011111010101001101000000000110100001100000111000100000010000001001
00001001101001000000101000000100100100111100000101000000000000000010010000101010000010010001101010001
11100010001000010000000011110000001110100101011010010100100101010100010010000110100100001010000000000
00100111010100100011000001000001000000111111100100001001001000101101010100101000000011001100100001000
10110000110000000000100010001010000000000100000000000100011010100000001000100001101001000000000100100
00011011001000000010100000001000100101101111000000100001001010100111110001010000001100001000010110100
01011011100000100000111000001110100111000000010000010010000000100000010000101000000010000011101100000
10000101000011010001000010011101000001001111101111000111110010011000001010100010000001000010100001010
00000100100000000100101100101101110101000001000001000100000011111011000100001011011000100001000000111
00000000011001111101001000100110000000001000110000100111010100010000000001000100001100001110100000001
10010101010100001111101001101100101011000110100001111000000001100101000100100001100000110100000011000
00011100100000000000010000111000010000001100000000100110000000001000100000101001011000001101100000010
10000001000101001001001000010100101010000010101001001010100000100101001000100100110110000000010100110
00000101010000100000010000001010100100100100000000010010000000000110101110101100000000000000001000000
10101010100001000001000011000100100000000100000001000000000000110010101100101100000000011000000001000
00010000000000010000000010001100100101001000000010000000000101010001000010010010111010000000000011011
00000001000000100011100000000000110100110000000000001000110110000100110100100110001010001010101011000
00010010110000111010010001000110001010001000000011100000011100100100000001101000010001000011101000001
00110100000100000100101010110010001001010110000100001000000100110001011100000011100001101100100010000
00000010100100101111000000001100100110110100101101110010101100000100001100010001111000000101100101001
00100000110110000011000011001000001000011000000010000000000001010001000001000000100101010100000010011
10110010000111001100000000001000010000110101010010111000000100110000000000000000000000010000010010000
01000000000100001000001010011000000101000010011101111111000000100010000100001000000000010000000001111
00001100110000000000000001000111000011010000001000011010000010000001001010011110100111100100011100101
10100110001100111000001011000101001010010101100010001000000100000001000000001000101000000100100010010
00000000110010010000010101010010100010101101010100010000010110001010001010110100000001000000001000110
10011001010000011101100000100010001100010000001010000000001000010100000000000100000011100110000100000
01000000111000000000010101011000000011110000000000001001111000000001000000001000001100110000010110110
00001011000000000010010110000100001011000010100100000000110111111110001100000010001000101000100010000
00100000000100010000000011001011000011101100101011000010000011011100010110100011000100010110100100100
10101010000101000010100110000100010110110010001010001100000011010000011000100010000001000001000010010
10100100001000011010000000000000000010101000000001100010001001100110100100010011000010001100000000000
00101001001000000001001100000000010100010001001011000010100000011000000001000100000100011000111011001
00010011010000010100100001010000111100001100010010011010010000000000010000111101011000000010101000111
00100100000100000011100001000000000000011110110000000000000010100001001100000000000000000000000000100
00010000010000100100110010001000010101000000000001000000101000100010101110001001000000011100100001001
01110110011111010001011111110001000000000000110001000010001000000000000000100000101000001100001001000
00110010010100100011000110010000010010000000001100100000100100010001001100100010010110001001100001011
11011000101100000001001000000010000000100100001010010100110111011110010000010100001011000100111000111
10001000000010010000010000010111000001100101000000100010100100001100000001100110000011101000001100000
10000110000010000100000100001010011111001001000000000100111110001000000101111010001001100000000000100
11010010101100001100001000000001101000100100001100000100001010001010000010000010000000001000000010101
10000000001000001110100010100010100011000001111100100100010001011100000011010010010000001000111000101
10010000000011000000100010000010000000100101000111000010000001000110000001011100011100100000001101000
00000100110000000100100000000000000100000001100011010000000000000110001000001011100000000101000101101
00100110011100001101000101010000000101111001110010110010000001100110100001000000011100000000001011001
11110000100110000100010001101110111110000001000001110000101000001010000100110101001001101000011000100
01100000001000100101000100010000000001100100011100110000011100010001010101000001000010001000000101000
00100000000000011100000011000010010111001000011100010101000010000000000111101010000000000001101100110
11001000101110010001101010010011000000100100000011100111001001000100000110000000001101100010010010100
01000100000100000111100001000001000110000000001010110000011010100100000000001001100000101010011010110
00111000010010000000111001000001000000110010100011000001001111000000101000111000101100010010001100001
01100100000000101100000000000000000100000011000010001010100010000000001000000101001000010010000011000
10110110000101000000100110000011000000100010110110001001001000110000000000000100100100000001010000000
10010100010001000011100001000111011010000001100110010100010011110000010011000010001000100000011000010
11000010001010000100000000100000000101110001011100001010000000001000101001001001000000000001000101001
10010000011010000110010000010000010010001100000000000011110000100001010001100100100100110000000000001
00010001110011101000100001001010000000001010100000010110100001000011100110100000001100000010100100110
00001000001110000000100100100000100101100010110010000000111100110000001001010000010111100000100100001
01001100100100000101000000001000111000000000000001000010000000000010000000010000000101000001010010001
10001001010001111011010000010010100000000001010011001100000000011001110010001100010010000011000011011
10001011110000001001111110000100000100001000010001000110000000010101100001001000010001000001010100000
10101010000010101010000000100001010101100001010010001011000100000000000011010100000100100010000001100
00110110000000101011000000110011100100000100000001001110010010010001001000100110011010010101001100000
10000000000000100010100000101100001010000101101101000011000001000110010010100000010100111010010000010
01001000001011000001011000010000000100000100100110010000000010010011000000000101010100000010011000001
10001001101011000010001000000000000010100011000010000001001001000000110000011001100010010100101000001
00001100110010000011010111100111010010011011000001000000000011001100010010000010000010111000000010000
00100001010000011010110101010100000000101101111000000000001001000000001000011100100000101000010101010
00010010001111111100000101000110000001101010001111000000010000011000000010000000000111000000100000000
00101100001000000100100001100111100101000001010110110010000000000001010101000100000000000101000011100
00100000100000001010100000010011110011101110001000011000001001000000011001001000001001110100100011101
00001100000011100000001000010101000100110110100100000001100000100000110010101100100001100001110000110
11010001001000110010001010110000001110001000101101000010100011010001001001010000001010000010001110010
00001010100000000000010010010001010011001000001100000000001110001100001001110011000000000110000001100
10100000000000010000000000001000010001000010100001000010011100000101010100011000000010010001010000000
00010001101000100001100000101100100010100000101000000110100001000000000000100001010101101101011000101
10000010110000001100111010100000010010000110010001000110000000011101001000000000101100010101100111110
01000101000100001100000001000100000010010010100111011000010100100100000000100011101001000100101111001
10100000101010000000000011100010100100011000100011100001000000100000001110010000000010100111000000000
10000000100110000001100110000000011011000100000110110001101010101101100100101111100110001010101000100
00100010100101010010100011000100001011001000101110010100000000010111000101000100000011000000100110000
00000010010100000100010010000110000000001010000010110000000001100100010011000010100000100101001011010
00100000001100000010000100100000000000110010010010101100000010100000010000000111110011001000100111101
10100000111100001010100101100001110110001000100111110010010000010000000001100101000000100001000000100
00010101101000000000000000010010110100100100110110001001000001000000001010100000001000111000010100000
01000100110000110101100100110110000011100111000001110100001000000000100000010100101000010000000100000
10100000100000100101100000100100101000111000010000010000010010000000000110001000000000000001000100100
00100000101101010100000001000101101001110000101101101001010100011000101001001110010011110100010000011
00100011001000010100100001010000000100110000010110101110110001010001001001100011110000000000100110000
00011000000111101110011010100010100101000000100000000011100000001101110110000001001001100000100000001
00100000010100001000001011110011010000110001110010010000000100101001000001111011011010100011100100000
11000010000001000000001011100001010000000001010000101010100000001100001000001010000000100100000000001
01000011100001000001100100010100000100011101110000101000000000100001000000000110000100000100000100010
11010111100001001110001000010000001001000110100010000001000000000001011010000000000000000000000010000
01010000100001000000000000000100100011001000000100000000010011000100000000011000110100000000100011000
00100100100000001001010001000000110111000000011000001110010110000001101101000000010010000101100000000
