00000100001000100100010010010000100011100110100111000010000101100001010110000100001001000000010100100
00011110100000000000000100000010100000100110011110100010001000101100111010000000011010001100000000100
00000100101000000000001000001000110000000000111001010100001000011101000110010010000010101000001010000
01000000000010000101000101100010011000000000011000100101000000100000110100101111100110000001000000001
00000001000011001010010010100011111000001000010001001000101110010001101001000000000110000000000000000
00000110000000110100110010100010000010010010001110000000101000010011000011000100100010011000100001010
10000110011011100010100011000011001000001010010001010010101001101010010010100000101000001000010100010
01001001100000010000000000000000000100001101000100111000000000000100001001010001000010001100000010000
00000000001100001000000100000001000001101001010000000000000011100010000000010010000000000101000000100
10111001001101010010000001100001111001001000000001111101011000001101011010010100000110000100000000010
00000000101001000101001110011010000101100001111000000101010100100001110000100001010011000100010000010
00100011001000000010101001000000100100101101000000000000010010111001000000100100011010010000111000010
01000110010100000100101001000100000101101010000100101111101100010101000101101001000111110111100001010
00001000000100000001000010101110010000001010000010100001000000100010100010000100101001000001000010010
00001001000101000000000000100110101001011001000000000000100100100011001000000000011101111000101000100
11000001001000011010000010100011001100101000010100111000110000010000000010001001110010000111100110010
10100001100000010100010000110000000100100101100011100101010100111010010001100000000010100000100000100
01011000100100000100000101010010010110000011011100100010000100100010011000001100000001000000000010010
00100001000000101001010100010010000101010011011000001000011100010100000001000100000000000100001100001
00000010000111100100011100100111010000010100000001000010001000010000100000000101000000000100001000001
10101000011010100101000111000000001001001000000000000010010111100101000000000000010000100001000110001
00001110100010000000111000110000011000000000000100101001110110001000000110001111010000001100000000000
10111000001000000101000011010001100100100110100001001010000110100101001000000000000000000100001100000
00000010100101010000000110010011000000010011000100010011100000100000000000011110100010100101000001010
00000000110100000000010000100100000000010110110101000001000000001100100101000100100001010000000100000
00101000000000010010000010001000000000110000010011000000010010000010000100110010111000010100001011010
10110110111101000000010000100101011000101001011100000001101110100110100111000000100000000001000110010
00001001000001000000001100000001001111000100000010100010000010000000100100000001101000000100000000010
10000000000110000110110001000010001010010100001100000000001000001000000000011000100000000000000110100
10011110011100100000110001010010110000100010111000000010010100110010010000000000010001110001010001000
10000001000100110000000010001110000101001000000100110010001001010011010000000101000000010001000001010
00010100000000010000011000100000010010101001101000011001100000010011000101001001110000000011110000001
00100000011000110000001001000000010001100001000000001001010001000110000000010000000010011000000110000
10010001010000010000101000000001100111100110011101000001000110100100010000000110011100110010010000100
01000001001000000001010001010110001101000100110110010000001110010000001110010011010001100000000100001
10010110010000000000011000100000110101011010110110000010001001000000001001010011101000001010100010110
00000101001000100001001100001000000010011010000100111101111000110101101011010000110101000101001000111
00010000000000101000001010110110100000001000001010000110000100001001100000010000000001011010100001000
11000100010011000000100011000000110111110011000000000000000001000101000100001000100101000010010101001
01010010000110011000101010011100000010110001010010100101101001000000000110000010000000000010010010010
00010001000101001010000001000010001101010110111110011100001010000000000000010010101010110001001000001
10110010000100100001100010000000000011100001110010000000100001010100000011100100010000000000010100111
01011010000101000101110001100001101000011001100000000001000001011101000000101101110000010001000100001
00011010110000111111000001100000001010101010011011001001000100101000010000010010101000000101100100100
11000100011010100000001001000000000001100000100010000000000001000000000001100001010000100010001101000
00000000011000100001000001000111000000100001100001011001000100000001100001000101010000100000000111110
00011000101110010000011001000101100000000101001111111100000000100111001000110100000000010000010001011
01000100101000110110110010011000101100100000000000000010110010001000011100000001000000100000010000000
00001100101100100000000000010100000000001001010010010101010001001101000000000101000100100000010010100
00001100010101100000000000000000001101110010010100010011000100000100001011100111011110101100101001010
11010000000110000010100010001000001000000000000001000000000110110000000000000000100010110000000000000
00000101001000101000000001100010011001010011101000000000010000100100000001000000001001000000100000001
00100110110100101000101100011111010010100000000011000000110000010001001100000101100000000110001000000
00011001101010111000100100010000010011001100000000000000000000010011110001000000100001100100101101000
00100101010111010000000010100000000010100000110000000100001000000000100110000001000101010101000110111
01011001001001101000100000000011110000100000001000010100000001000001000001100000110000100001000110001
10100001001000110110010000001010000010110101000001010000111011000110001100000010100000010110010100001
00110110000010000100000001110100100111010100000000000000010001100110000101000000011000000010101000000
10011000011000001010100000000010100100000000100101011011001100010010011010100011100100010010000011000
00000000000001011000000011100110110101100100000001010101000000101010101000000001110100111100100000011
11000100100000100010100000100010000110010000011001100010110000010101010001100000000101001000010001010
10011111001001100001000100010000100101010001010001100101001100110111000011101000100000000100001100000
01000000001010000000110100100011110010001110100101100000110000000100010000001100010000001111100000110
00010000000000001110001101101000000101000010010100000001111101001100110000100000000010110000001010000
00000101101000000011010011000000000000000100001000011000000101010000010000000001100001010000000010110
00100010001011000010111010001100110101100001010100000001000100010001011101011000110000001000000000001
00010101000001100001001000100000110001001000101000001010010001110010100000011000000011000000000100000
10110000001000100000010100100110001001001000000010101000100001000000000100000000101010000010100000010
00000000000101101110000001010011010010000100001110000000011100000001101101100011000010001010000000010
00001000001000001010000010111001100100100000001100010101100010000000000000000000010010110000000100010
10000100011101000001000000010100001010100100010000100001001001100000000000001000001000000101000000000
00000001100011000011000100100001010110000110000000010000000101000000100100011100001000010001000000000
01100111000000110101100101011001011000000001001000110010000110000000000101001011000000100001110111100
00101000110111010000000001010000011000000010101000001000000101000010010100001100111100000001000101000
10111001000100000100011000011011100010001100000000000101100000000000010001110011011000001001001010000
01101010100101000101010001001001010010000001000100101011101010100000000000001110011000001111101101000
00111010010000101000001011000011010000001011001101000000001001000001001011000010101000001000001000000
00000000000000100001011010011000000010100001000000010010100000100000001100001001000001101100010001110
00000000110011010010011000000010011000010000100001100001001001100000101010100110000010000000001000111
01111000001000000100001010110000100010000010010000100000000100000010100000100000000110000000000110100
01001010111001000000110000010001000000100010000101110000001101001001000101101010001000000100100000000
00100000011001001110001101000101000000001100100101100010100000000010000100100000000010101000111000100
00000100000000001011001001000000001000000100010100000111100011100010000000000100000100000001011000001
00000110010000100010101000000010101110001100010000000010000101001110000000010100101000011101000001100
00000100110100111000000000100000100000001001100000001000001000110000111000001000001000101110000010000
00001010110010100010001011101110110100010001101100011100001011000000000101011000110000010000000011000
00000000000011110010000010000000000100000001100100100000010110110001000100010000100001100000001000100
00101000011000101100000011001101000001011101000000000111000000000000100100100010010010010000100000111
01010010010100100101000001000101100010000010000000000010010010011000000110100001001010100100001100011
01000001000000000000000010010000000001101000100000110100101011000010000001010001011100000000000100110
01000100000000000001100100001000010000001110001101010100000000010001010000001001001000000000001000110
11000000101000001001000011101000101111010110011000000000000000001001000001010000100001101101001000010
00000001010100010010100000000000101001100001000001101000000010001100001001000010000101011100000000001
10001010001010000111011001001000011110111000101000000000111000010000000001011000111000010001100000101
10000000011000011000010000010110011010000001100000001000001000100100000000010000000001000100110001000
01010001001001010100111010010000000111000010000001001000100000000011000000100000011100110010000010010
10000100110100000000011010011110000001100100010101101001010010001000000000001000001000000010100000100
00100101100011101010111000010100101000010001001110101001100110010000100010101100000010010101000100000
10000100000101011100000101000001000000011000000000010111000001000010010000001000100000000000001010000
00000110000010101000011101001001100000100100110100000001000100001111000001110100000100000001100011000
00000100011000000101001001100011100001000101000000000010100000000001010001000001000110000000010010110
