00001010100011000110001100100001000010000010100001000000100101001000000001100010010000000001110000000
01010100000000011001000000011010001001101111001000001000010000100011000000110011001000100000100001000
10000100100000000010100000000110100000000000010010110100011001011010000000100000100000000101100001001
00010011001000011011000011010110010001000010100000000100000000011000000011000000001100000001001100000
00100010010011110001000000000000001010000100000010000000010011101001011000000100100100000110000011011
10011010010101000001010011011000011000010111000100111010000111000100001011100100011001100000100101010
01010000000011100111010000010000010010000001000010010001010000101110010001100000000001011100110011100
01000000000001100100001000000010000000001000000000001010001001000000000010000100000001000100001001011
01000100000001100100001001010001111000101100011000100000010000001010001011100000110000110000001010010
01110000000100010110010000100000100000001110001100110001000000000000010001000001010111000010000101010
10000000011110110011001001010001110101010101100000100000010100010100000100000101010000010000100000000
00101010010010110110100010001110110011011010000000110000010000100000000100000101000000100000011111000
01010101000110011110000000000100000000101001000010010000010110000111101011000010100000000001000000001
00000001000111110000101000001010101011110011000110100000001000010001010001101000100101000001000010100
00000000000001100000010010000100001001010001000001100010010010010001000100100000001010101010011001000
01010101010101100000101110010001001110101001011011000001010101110001010101000100001000100001010000100
00010000000100110000111001001000000000000001101010001100000100101000100000010110001100000101000100000
01000000001000000110010000000001100010001001000001110001000010000000000011000101110010000000010010010
11010011000001101110000100001100000010100101000100010000001101000110000010100110100000000100000110010
10010000000001100000001010000011001011110000000000000010010000001110100000010100000100001111010000100
11011101000001000010010000100010000000001011010000000000010010100000000000111110001110001000010001000
01000000000000001010000010010001010010000000000111000000000100011010010000011000001000110111001001000
01110000001010011001001000000110010001000000000001000000100110000000000010000010010000011000011000001
00101000000000001000000000100100001111010101110010011101100000000110000000100000001011011010011101000
01100000010000000001001000100000000010000011010001111000100000001001101010000010000001000010000010000
00010000010000000100000000000001010100000100000101111000010001000001110000000011010000001111001000010
01100000111100000110000010001010001000111001000000000001001000001110100100000010000000000010110010001
00111000000001000000000000000001000100000101110010010011000100100000000101010010000000001100001000011
00100000111001001000100100001001011000110010000000010000000000010001000000100000001001001000011100001
01111101100000101000000110100100010000010000010011000011000000110111010000000000010100010101010010011
00011001010000011001011111100000000010101101001010110110000000100011100011011001010100011000101010000
01000000101101010000001100101000000001100111010010101010010011010011011010000000000000111011010100011
10101010100010000000011100100100111010010000000010000011001010101100001001001000110000010100111000010
01011000100000000100001100110000000001001100100000010011100100101000001000000000000110011000110000000
01000100000000000100000000000000100110000000010100011001001000000010010100000100000110001000100101000
10100001001001100100000100001111100000011000101011010000000110010100100000011000000000110110010000001
01000011000100000000000010011000100000101000101001000100111110001010000101110010000100110011001100000
01001001100010011111010010000010111011100000001001000000100001000010010010100010001100110001011111100
01100110010000011100101110011100000101000010001010100011000000010100000010000110100001011011010010110
00010001010001000000101010001011000001000100010010010100001000010100000011010000100011000000011000001
01010011001000000100010000010110001000110000110100010000101100100010101000111111010000000001010001010
00000001000011010010000010000000000001000110001100100010001001001000001000001000010010111001000010101
11001000000100010011000010100000001010110001000010100000100010010011111100001110011010010110000100000
00001000010010011010000011100000000101010000000000100000000100011001100010001000101001010000000010010
00001000000011000000001000000100000000100100000011011000000101001011000010000010010110010110000000001
01110000001100100100001001000000001101110000101110000000101010000010000100100010101000001101001000000
10000010000100100000100100001010000000010001000100110100000000011110010010100010000011000000101101001
01001010000011000000011010000100011100010001000000000011001010001010000000101000010100101000010100010
11000001100011001000011110100000011010000000010000011101101001000000010000100101000100000000100000000
01000100010010000001001001000000111000000010000001100000000010011101100110100110110110110000000000001
00010000000000110001100010101000100000100010000000000100100000010000000101001001010001010011000010000
10011000000100110010111011000100101101001010011010000000011001111001000000010100000101100000100000011
00000010000000011010100010010000001000110000000101001010111000000000001001000000000001000000101000100
11010000000011000001010110010000000110001001000100010100000110001100001000000000000000001010100000101
00100000100101100100000000001001000000000101010011100001110011001011010000000000000111100000000010000
00000000000001000100110010000100100000111000000101001100000111001000000100001010110000000100000001000
00001000010100001000010000101000001010010100011101000001000011000001010010010000100011000000110000000
00100100000000000110100001100100001000001001001000100110000011000000001001110001010100100000100001000
00001010000010000010001000000000100100000010010000010000010000111010001001010101001000000010000110010
00100010000101100001011001000100100101001101101000010001110000011000110000100001101001100000000000001
01000000000100010100010000000100000010000000000001001110000001001000000000000000011100000110000110000
10100001000010010101110001011101010000010000101110000110000001001110101000000100001000100000010100110
11010000000000111001001000001000000100110000101001001000011000000010001110100000110100100010000010000
01101110010010000000010000010000000000100110001101000000000010010010100111000100000000000101100000001
00011000000100010000000100000011000111000001010000010001010000010101000100000111100000001010000100000
11001111010100011000100010111100100000010110001010100101100010000110001101001000001100000000000000110
01000001000000010000010000100011011011000100000000001011110011000011000010100000100001011000110101010
01100110000001000001010010000000110010010000000000001100000000100001010000000000100000000000001010111
00100010000100000101000011001100000000001000011110000100000001101011011000100100001001100100010010110
10000001100100000011010010100000101001000000001001000010011000000010000100000000110010000100110100100
00000000110100100101010001100001110100000101000010000100011001010000100110011001000101010000011000100
01110000001001100110000010010000100101110001101001010010001000000000000100000010000010100010000000000
00001000001010000001001011010100001001010010010010010000010000100001100010011000011000011000000001010
01000001100000000000000000010100010010101000000011010010001110011000000000000000100000000010100010000
00100101101100000001001011111100100101000011001001010010010010000000001000111000001011000100010100000
00010100001000000000000100000001101010000110010000000000011000001010010010000010010000000110010001010
11100010001000010010111001100000000100000100010001011100001000000111010001010100001001000011100001000
11010010000101100011000010110100010000010010011010100100000100000000000110000011000001010010100110000
00000000100000010010010110011011100001101010000000001001000111100100011010000000100001010001100000000
10100011111010001000010000010000010111111010100010110000000010000000000010000100100000100100110010000
00010010000010101100000011001110000000000011011000000000000001001000000010000001000110001000100100000
10000111001000000001001010001011100000110110110000001000010000001000011010001010000010001010000100100
01100000000000000001010100001001000011011111000000100001000101100000111010001010101100101000110000001
00000010001010000101011010010100100011101100100000101110000100100010000000110000000010010010000000000
10101001001000000001010100101000100101010001010011010001000010000000001011100000001000001000000000011
00100100011011010010000100000110000010100101110011000010100010100100000001010010010000011100101011100
01000100001000010000000000101001011101000010000000110000000010111001001000101100100010000001100000111
00100000010100011010010010000110100000010000100100111001100001000000000001000011100000000000000000100
10010101100100101001000011000010000000000000100001000010000100000000011001000000000001000111010000100
11001010000100110000010000100001011001100000110000010001000000010000000001110000000000011000000000000
01000001100000000010110000000000011001011010101010001000000000000001101001100111011100000001000110100
00001110010001000001100000010111010001100100000001010001100100000000011010100000011000000000001100011
00010010010111101001000111110010001001000000010000010011000010011000101000001010001000000000101000010
00101010000100000000001000000111100000000101110001001010000000000000000000111001110111101001000000100
10000010011001000001000100100011001001010100000001000000000000001001011100000010000100110010010001000
01100100110100110000000001000001010000100000000000010001010100001000000000010110001000001011101100001
00000000110100000001100000001110100000101010100010000001000000111000010100000100000000001100101000010
01100001000000010010000000000110100100000100000110100100000001100100000000001011000001001001000000000
10100111000000011111101000011010100011000101010100011010101000000000010100011000000000000101100000000
01001000011000100101010000110011101100101110000000010010010011110110000010000000000010000110101001100
00000000000000001100101000111000000100100010100100000100010000000100001110000000000100010001100100100
