00000001000000010000000000100100010001110011001010001001001000100000100010001000100000000001000000110
00001010001000101000100101010100000000000110101001100000100100101000001010001001010000000001110011010
00001000010000110100000000111110000011100000001000011000100101000001010000110110000000010000011010010
00001000000001001001000001000101001010000000100000001100100010100000000110000100100010000110001100000
00011000001000100100010000010011010000111001010110000111000000001100100011010011000110010000000000010
10001001000100001100000000100100000010100110100001100001000011100100010101110001101100010000100010010
11100011100000001000000111010101100100111101110000100100100000100110100100001101010000111000000100101
00100110001001001100110000101000000100011000100101010011000000011000000111010000101000001111110100000
00011000100110001101011100100000000101000010100010000000011001001000010010000001011110100100000000000
10010101101010000000100000101001010001000010000000000011001101010110000101010111111000100100100100010
00000101001011101111100101000100101000000000001100111001000010110000001010110000011000101010000010000
00100101010101000100000010011110010110010000100001011000000000001100000000110000000000000011100000101
01100100000100000001010011000000011000000000000000000111110001001000010110001000000000000011100000101
10000000000100001011100000000110010000010001001101000001000010000000000100100100101101010011010101110
01010000000001000000010000001000100110000100100000100000011010010100001011001010110001000010000011000
01100000100010011000011110010010110000000100010000000100100011000110010001101000110000010000000001100
11010110101000000110010001001001010010011100000000100001100100100100101000000001010001000001011001100
01111000001000101000001100010100100000000000100101001100000001010000000000001000011001000010010010000
00100000110000011101101001100010100000100001110101001011110111000000000100000001101000011110011010011
00010001100001000000001010001000000001010000011010000000100010000001100000000000100101100000000000001
00100100110001000110000000000101010110110000000000000000100010111100100001010000100001000010010100010
00010000001000101100110001010001011000001100000000100101100100010010011001000100000000100101101001100
10010000001000000000001000111011011010001100010010010000100000011001100100011101000001000010000001100
10101100100010010100001001000011000010110100010001011101000000000010101100110110110010000100010100000
00000100111010000100000000000000001110100100100110000001100001001110000001000011100010001000100010100
01001000000100100001001101000101000100110001000001100000101001000001000100110001101010000101100111000
11100100000010000111100000110010001100010111001111001000101001000110000011100000100100000011000000100
01100001000000100010000001101010010001000100000000011000000011100000010111011000000010010001001010001
00101000011011110001000010000001100100000000011010000000000101000001101001000001000001000000010101111
00110000101000010000000100110010000100011000000001100000001100010000000000110110000000011100101101110
10101110101111010000100100000000011000000101011001000110100000101000000000001101000100010000011001101
00100100101010000110000000000000010110000100110010100010000000110000101010000100011000001110010100010
01100011001011010101000000000000100001101000000000100000010010011010000000111011010110000011011000000
11010000011110000000101001001101110000010001110001001001000010011000010000000000011000000110000000110
10101010000100000000000101010010010011000010000111001010000001111001110000000000000000010000000001001
10000000000110010001010100000001000001110100000010001110000001001000100100010000001010100000111100100
10000011001011100101000100000000000010010101111001010000110000010000000000110001010000000111100000000
00110111000000001000010000000001010010000001011010100000001101000000011111010011001000000001110011100
10000001000001000000001001011110001100001001001001010010100000011111100000000101110111101010100000000
10001001100011000000010110001000000011001101011100001011000000000000101001010101000010010000000110000
00000011100000000100101001000000111011000001110000011000000101011000000000110000000100010001000001000
00000001000100000000100000000110001000000010000000101100000100010010010001011110001000010101000100000
10110010000101010010110000000110001000001100100001001100011010100000010111000010100101100100000000111
10010001110101001000001100010010010110001010010011010000011101000000000000010001110001000000100110000
00000100000101100010100000000110000100000101001101011100000000100010101010000000010000001000001100001
01010100100010011001010101101000100011000001000100000000001111101111000000100010001001000000011001000
00000000100011001000010000110000000011000110000000100010000000000000010010100000010010000001100001000
00101000001000001010000000000110101010111000010011001001011100010010000001010100000100000110000001110
11001000000100001001100101101000010110111100001011110100010000000000100101110000010000000100010010000
11010010100110001100100010010000001110001000010001000100000101011000101100110000001000000001000101001
01000001000000110101011000010000000111101010111000010010001101100001110111010100000001100000011000000
01100001111000000010000011000000001000001000111010100101001000000000000110000101000100000100010001000
10101000100100100001001011011010000100000000101100001000110110001101100100010000001100111001111000000
10000001000000010100100010011000001001000101010010000000011010000011000100100011100010001000000011001
10000100010010101000000000001100111110001000000010000001100000011001000101110000111001010010100010101
00010100000000010000000110110001100100000100100000001010000000110000000101100000000010000101000100010
00000001000010000010001000111100100000000001100000010010010000010001001110100000100000010001110111000
01110100010000001001100010000100000000101100101001110001000111000000010011101001000001010000011001010
00100000010000000000000110000000000011001011001100010101001100000100010100100011111000010000000001100
00110010110110000000011000101000101101011100101011000100101101011011100011001010000010000111000010010
00000100001011001001001011010000010000110101010001010000000000000010000000000100100011100010011011010
10100010000010101000000000000001101001110001000100001010110000110100000001101111010000000111010001011
01001100000011010100000100000011000010001000000100001000000111000000001011000100000110001011001010101
11011010000010000011101011001010000101001010000000000000000100100000001000000001000100001100010111100
10000110000000001000010001000101000000100100010000000000100100100010100000001000100100001111100001001
00100000011001000001100001000010010010000001001010100001010101001010010000000110000000000010000010110
00010100110001110011010001001001011000000100001101000110100101111000011000001000000010010000000001100
00110010000100001000101001111010001000000100010000100010000010010100001001000000001100010010010010011
00000000110010000111010100001000100000100001110000100000011000000000100011101001010001010000000000101
00001100110000010000100000100001000001000000001001000011010101010000101000000000111100110001001110100
01100011001001100100000000111001000000010100001010110000000010010000100100000100000000000001111100101
00001001000110011000000000101110000110010110000001000000000000110001000001100110001000101001000001010
01010101010010011100100001000100000100100011000001011001011000001000101000000000010001001111011000010
10100000001001000000000001000000110001001001100011001000010000011000010011000110001001110111000100001
10000001100000000010010000000001000001000101010001011100000010100001011100010101011100010001010000001
00010111000100000000000000100010000010010000000000000000000101000000000000000000000011000000110000010
00000110000001100000000010111110010100011100000000000000100100001000000000100000000000000000011100010
00001010110010010001000100001001010000010010110110000001010001000000010011000010000010000100010000000
00010101000000000010001011001000101000011100000000000000010010010011010000100000000000000010000000011
01100000010100101100000101000100010010001011010000101011101001000010010000001000000101000000000001010
00101010000000000000000000000010000000010001000011010100000001010000001000000010000001000001010111000
00100000000100101011001111000100000000000001000000010001000100001010011000010001100011100010000000001
11001000001001010010110001100010000001001000000100000101000010011000000100000110000000010000000001000
00100011000001000001000100100000010011010111001000001000000101000010000000000010001000100000001100100
10010000111101000101101001000000001011011001000000010101000000100000010000000010001001011000000010001
11010100001100100000101010110000100111100011100000100000101010000000000100100010000110111001000101000
00000001100000110000010111010010000000000100001010100001000000010001010110001010001001101010101101000
11101000101101001000000000110000100000001000101000010101000000011000100000001000000011110100100001000
01000000000010100100100011010000000001000001000001000011100000100111010000010011000011001001011000000
00010110000000011000001100010100100000000000000011110100100100000111011010110101000000010000110001000
00000000000110000010110110010101000001100100000001010000110010000001111100000000000010000100000100010
11010001000100000000001000000101010100011001110011100000000111010100110011111001011010101110000000010
10100010000000010001010010000100100110111001100110100100111010010101001000000000011000010010000100001
00000100010101111000001000000010110100001110000110110010011101000001000110011000110100010100001010110
00110000110010000010000000000000101101010001001011101100010100010111010100001100000001100000000110011
11101000110010000001010100000000000000100000010001000100010000010000000100000110001110100001000001000
01001000010001001000000010101001110100000001000100010100000111101101001010000010001010100001011000100
01001100100100100010101101001101000000001110000001001101001100110100000000100000111010000010000100001
01000010011010001010010100000110000101100101100110101000000010010001000000000001101101000101010000000
00100100000010100000010101000011000001001111011101000100001001000101101100000010000000001000010000000
01001000000000000000001011000001100100000001110100100001000000001011100111010000000100001000000010010
