00010001000001000011110100100100000000000010100000011010010011100001010000000100100010010010111100000
00100101010100000001001001000000000100101000100000000010001000001000100000101001000011010010001100100
00000000011110000000100010010011000001001000100000110001000101000101010000110100000010011011000000000
01010000001000100000101010001000000111000011100011001001000111000111000011100000001100001110001101100
00100010110000000010010000000100010000101010111010001001001001101000000000000001000101000101000100100
00100010100000010001000010101000100100101111001001010000001000001101000011000010010000010000000011111
00101011011101000100101001101001010110010000000101000000000000010010001000000000010001100100010000010
10001001000000001011000100011011001100010100001100000000010001011100100001100100000001010110000110100
01100000000010101001010110000010011101101000100000101100000111000010010110000100000001000100000001000
00000000110000001101000000001000011100000110110000000000001001000100000110000100010000010000000010000
00110110100000010010010000010101010000000101110111001010000011010001010000010100000000000001101011010
00010001011000001101010001110001000100000000100101011100100001000101110000001010101000010000101000000
11000011010101001000000000001000101000000100100111100001000100000011101010101000011100000101001000000
01001010001011100101000010001100001000001101000100000011100010011000010000001100100010000000011000101
00010001000110000000011110000000100111110101101000010100001001000001011101100010000101100010001000100
00100010001100100001100100110010011101010010001011010001110000001000110000010101000001101100000000000
00100000001100101001101000010101001001100010000100100010010101010010001100101001000100001000100000000
00100000010000100000000000000000000100001101010100100010011001100011101010010011001100001100000100100
00000000000100000100010001010000100011010000010100010000000100000101000100110000000000101100010000101
00001000001000010000100000101000000011111010001011000001001011000101101000000000001100101001010010110
00000010011100001001100000011010000000010000000100010000100100110100000000000000000000000100111100010
01001000011010000000011000110000101000000100000111100011111001010000001001100000010010010011000001000
00010111000001011001010011110010000100110000100010111000001000000000100000010010010000001100100000000
00100100000001011000011000001000100011000010101100101000010000010001010100110010101000011000000001011
10010000010000110001110100110001010000010100000010110001000111000110011100000011110111001000001000101
00000010000000000011000000000001010100101010000100000000000000101000000000100011000000000010010010100
11010000001001000100111000001010010011110100001011000001100110010100000001000001110011000000001100001
11000011010001000011011000110000000101000110010110011100100000000010001101010001010000010100000000101
01001100000001110010010100010000001010111001000100010100100100011000000110011101011100000000110010010
10001010000001100001000110000110101101100100110000011000010000010110010000000000010110100000010001000
11011100010001000000010000010001100010000011000101101000011100000011000000000000111000100001001100000
00000000100110100001000100011001101010101000010010001001000100000001101001101011001001100101101010000
00011000011100001100010101000011010010011010000011110010000000111000000100001011000011000110000000010
10010011100001000000000100001100010100011000011001001001011010010100011110001110011111011010000000100
00110001111001000001011000100110000011000101001100011001001000000110101000110101001000000110010000001
10100101001110010010001011111101000000000010101000000010001000110101011100001100001100000110100000000
00000000001001010011010000001000000001101000110111100010011011000011100000100100110010111010100000110
11000100000010011010110000010100010000111001110001010101000001000010111111001100000000001000000000000
00000110001000011000010010001011001000000100110100010110010000101000100000110110111100010000010000001
11000101100000110000000000000001000010000000000000011000001001001010110011100110000000100000100111010
00000111001100110011101100001000000010001010001011101010011000100000111101000011100110110000000010100
10100000000000010100000010000000001000100000000010000100101000111101001100110011001100010010000001010
10000010110100100000110000011001100000010100000001101010000000010010110000100100011000000010000000010
01001000000000011000000010101110010000000100110010010000011100100001001000110000000100000010000110101
10000001010000011110000001100000000000000000100000111100110010000000110100010010001111000000000010011
10000000010001010010100000001000000011010001010000001000100101011000110110010100001100010010010010110
00100001001110100101011001001001000111000010110000010000101000001001000011001000001000000000101100001
00001010000000100010010000010111110000000010000000101010010100000100101000001000111010110101000000110
01001001000100100000101001000010000000001111000000000001001010000010110001001100100000100010000000110
01000000110001000110000000010000000001010000001100000100011010001000010000110101011000100000001011100
01111100000000000001000001001000000010010001011001100011001000010010001101000100010010010000011011111
00000100101000000100001000001010000000000101100001110000001100000000011000100101010000101100101000000
10101100010000100100100001100010010010011100001001110000001011000000101000100000101010101100100101000
10000110010000001000110001011000110001000010000010110001001100001001010000001000001110000000000000101
01010000010001001000001000010000001000000001101101011000100000010010000100000100000100111000101000000
10000010010111100101001011110000000111000001110010010000001000000000010000100010011000110110010001001
10010010010000000000001010000010000010000010011010000001000101100000000101000001001000010100010000000
00110010000000000110000000000010010110000001011010100010001110100010000000100100100000000011000001000
00000111000000000000000011001000000101100000000101100000000000001101100101001001100000000101100001110
00010000101000100000010000010110000000100000000000000100110100000000000000100001000000000011110110001
01000001000010100010000010001100100110101100001100001000010000010101000001000001100000010010001010001
01110000100100000000000000100000000001011101000100000100101010000001100000001000000110000000100100101
00110000010010100011100010011000100011010000011001100000000000011100010000001101010000000110010110000
01100000001001001001000101001101000010010000000000001000001010100010001100000000000100110000100101001
01101001010100100001000000001000011100011000001000001001010100010010000000000010001100000000010000011
01000110010010010010100000100000110000100100000101110010000000110110000001100100010001000100100000000
01101100110001000001000000000001111010110000010001001001000010000010100010000001010000010001110011001
10000000011101000100011000000001101001000011110000010011010001010010000101010000000001000111000111000
00010001010100001000000101001111000011000011000001001000001001000011111100000000000000001011000010111
00010001101000000101110000000010000100010000101000100000001001100010101001110010101100010000010000000
00100000101010001100010111100010001110000100010000010010001001000100001001001000100000000100000000000
10000010010001001101000110000000110011011000000000100001000110110000010000010010001100100100010010000
00110011010010000111100000000000100100000000000100000000000000001001110000101000000001010001010111001
00011100110011010010001000101100000000001000001000010100000010010000000000100011111001111100010100001
00101000000000000010010000100110011000101000010110000001000100100111000100100100011100000000101100010
00000010000111011000100001001000000011000000000000010101100011100000110000101000001010100101101000101
10010101001000000000011000001000010110100000010010000010001001100010001100101101111000000011100010011
00110111100000001000000000000000000000010001001100101000001000101001000000101000100100010001111000000
10001000000000001101010001000000000000010000101000001111001100011100010100001011100011000100010110011
00100001000001100001011100000100000100010010000100010010101000100000100010100010000101100010000001000
10000100101011010001000001000000101001000000000001000110000101100100000010001100000000101000000110000
00100101001110000110000000001010000001000001010010111001000001100111110010100000001011000010000000010
00000000000100010001001001000010001101000110110000000000011110000101000101000011100010011001010101000
00001110000000000001001000100000100110100011000101100100001010000100000110110011010000000100000100001
00001001000001010110001000000110101100010011010001011001000000000100000011001110000010011000000001010
10000101000100100101000101110000100011100000100100000010001100000010100000110110100011100000100001001
10000000000100001000100010100000101001001100100000000000001000001000100100010011000000000001110010110
10000000001100101111100001000101010110010110100000001001000000001010011110101101001000010001000010000
11010000001001000111000000001000000000110101001000000110000110000101100000010101000001000001111011010
00010000010101000011000000000000011101100000111100001110000000001100000000001011101110000011000100000
00101100000000100011000110010011000011110001001001010000101100000000000000000110001010100000110110000
01000000000000110000000011000000000001010001000001101000000100000000001001000100000010000110100001010
01010000000111010100100110000001000100100001000000100110000001000101010000010000000000000100010100000
00000000000010011000010111000000000110100000001011101101101101010000001101000000100000100111100100011
00000100000000000100001001100000100000010000100000110110000110000000100000100110001000000000101010010
11000101110100010100000001100010000010101100000100000000010000010101000000100111000010001111010000000
10000000010000001000001000000100100101000010110100000000101110001000000101010000100011110111011101001
00000011000000100000000000000001001000011111100000001101000000001111010110101000010110001100001011100
11100000000000000010110100000110001001101100100011000100000100001100000010010110010000100100000000000
01011110001111000000100001100000100100000100000010010100010000000000010101100110011011100110000010000
00100000010011001000000100010100101011100111000010101000101110010100000000010000100011011101000100000
