00010100000011101010111001001100010000111000100001100000001111111100110000001010100000000000011111000
00000000111001100010100010010000000100101001101001001000111101001010001000000011001001000000101011000
00100110000000101100010000001100000100100100000011000000010001000001010000100000101100010001011010000
01010100100100010000000101000100000000001000011011000000000001011000010011011000001000011011010000000
00001010010001010000111000000010100001100100010000000100100010010000001000010101000011001110000000011
01001010101000010010100010001011000100001000000010000010000001101000000011010001001100000001010011110
10001000001111101000000110000100000100000000000000011000010011001101000101000011110000010110010110000
11000000110100000001101101110010010011000011001101100110101010101100010100101000010001110001010000100
00001000100000000100011000000000000010000000010001000000000000101000100000010000000000000000010011000
01111000110001100001001100000010011010000000100001000000101001010101101000001000000000000100100001011
01011010001000010001101001000000000100010100100000100111001000010001010101101100000110110000100100001
00011000000000010100000000000100100000010101000010000000000011001101101001011100000001011001000000010
00001000100000010101000000100110100101111111110001100010100000001001010100000100010100011001001100101
11100001100011100000001000010001000011110000001100000100110000100111000000110000010000001010110010010
01001000010011010101000111001110010000100110011100000010000111000100101100000001011010101000101000000
10001000010100000010100001000000000000000101000001100000000001000100011000110010110000000001001101000
00100000010001000101010010000110000010010011101000110100001000010010100000000010010001001101000001000
00001100000000110000110111100010000000100000000000001000001100011011010011000001000001100001000001000
01010001100000000000010101011010000001001000000011000010010001000100010011011110001000000101000010001
00000100000000001100101011111000100011000011000000000000110000010001000001010011001010000010001000100
10000011101101110000000001101000000000000100010000000000110010000000000101101000001000100100011001100
00000000001000010011100010000000100100000100000000000000001010000111000000001011000000000100100001010
11101000001011001100010110010001000010101000110000000000001001101100001000000000100010101010011010000
01111011101001011001000100100101011010110100111101100101001000000000000001010000110001100101000000101
00001001000000100000010001000001000000011000100000110010000010000000000000000111010111100000010000010
10100101110000100010100111000110010101101001010000000100010010001000001101000101010001000000000010000
00001000110000101100100000001001010000000001000100000100101101000100001010111001010001000100001000010
01000101000100110110001000001110000100011100000010100001000000001000000010001100010010100001010110100
00000000000000000110000000001000010000010001000111101100011010111000000000000000000000100000000100101
11001010000100000100001000000001000000001001000100111110000000101000110000100010000101000101010000011
00100000001001101000011001011001001001010100100000100001101110001010010001011100011000000010000101100
00100010001000010000101111101000010100011011000001110000010001101000101101110000000011010100000101100
00001000000000000100000010101010000000101011010010000010100000010001100101110000101001100000000001010
01010010001000100000000100001100011010000000001001001100000010000000001000000001111011110000000000010
01000100110001101000111000001000010011101010000111100000000100010100101000100100100010001000000010010
01000010000110000100000001000011101111000000010001100000110000000000110000100100001011010100001010001
01001001010010000000110100111000000101011100000011000010011001011000001000000100001101011011111110111
10100010000011001011000000010000000000001001000001101000001010010011001100101010000000110001000011100
01001010011001101000100110011000100001001000000001100001100100000000001000001001100100000100010000000
10110011110001010100000100000100000100001000001010001010000111110000101001000010100000000000101110000
01010001010110101010000100100111100100010111111100000001000000010100010110000011100000000010111000000
00100011000000110000000101100000000000001011111000010000000100110010000000001101000001000000010101000
00011001010000110100101010000101101010000000000010100100011100110010000000000110100001100000101100110
00000001000100100000010100000011011100110010111010101010001111101110110001010001110100100100010010100
10010000110101100001101000100000101001010100110000000010010010000000000001100100000000110001011000000
11010001010111001000000001101000000001010100000010110001010100001010101001010000101000000000110010001
01000011110011100001001011000001100100010000000000000010110100010110000000100000000001101011100010010
01110001001000000101001000000011100010001000000100001011000011000000010101100010011011010010000010010
00010000001010011001011000001001100000000100010000000000011000000101100111000000000110000000000001010
00010101011100001000001100000000110001000100001011010110100101000000101100010000100010000101001000000
10000000000000000110000000001000100100000101000010000010110000001000101010100000000111101100000011100
01000000000010100000101010000001010000111110000001000001000111000000000010011000010001000000000000000
00000101000000111100101000011110001101010111000100111100001000100100000010001010011100100000001000010
01101101011010100011000101000001101100000100100000011111010100110010000011010011011000000000111100101
00010110001001100011000010100001100001000000010000000000000110011100000110110000000011001001100000010
10101000010100000100010000110000100101010000100001011000011001101000000000010000001001000100100010010
10100101001110000000000000001100000000010001001100000000100001010110100101000000110100110110000001100
10000000000011000100110101000010000000110000000001100010100100101001101011000001000000001001010000000
10001010000000000101000000010000101001010000000110000010000111000011111010000010000001000000000000000
00010001011110000011011101010000100000010110000000110001011011010010100001000000000100010001000000000
10000100000000001001110001011011000100001000001001001010110001011011001010000001000100011100001000011
00110110111000000110010100100000000101000001100000101110100000000001101000100110000100100010101100000
00010000011001000000001111001010101000000100000100100001101100000011011000000010001000001100001011000
11011110000101101011010010001010000100000001111001000000011000010100100000101111110011001010001110001
01000100110000000010000101111010110011001100000010000111000010011101101001010000011110100001010000001
00000000011100000000010010000100001110001011011010101000101001000001100000000100000000000101110001011
10000010000000110010100010100000000010000000110010000000110000000000000000001100000100000000010000000
00000100010000000000010000100000010010110110100000001010010100100100100011100001110111000101000000010
10010011000100000000110000101000010010100100000010000000000000000011100011001110001100001001100001000
00011100000000000001010000111100000000000011000101010001000000100001100000000001000010110001100000101
10000101000010001001000001010000100000010001000010000101011001001101001011010100100000101001000001100
10010000000000100000100010000100011111000011110100110000001010100010000010000100010110110010000010000
00000010101000100000001010000100001010110000010000000110100000000000010011011010000001000100000110000
00000011010001001000000100101001000001000010000100000101000010011000000100001000101000000000000010000
00101000010110001100000011001101000001010001101010101000000001000110000100000000010000000000000000100
10011000000001010000001000000011100000000101100000000000001000010010001001000100100000010011000000001
00001100000001001001001000010000000100000001100000001000100010110110001000010000100100000001000100100
11111000010001000110100001001010000000001100001010100000001101000010101100100000010001010001000011101
10010001110010000011100101000010000000000100100011110010000001111010000011111011011001011001011011001
00000000111010101101100010010001110100000010000001101000000000100100111010000100001000000110000000010
00000000010000010000000101100001000101000000001010000101101001000100101100000010001001000000001100001
10001010010100100001110000000001000110011110010000011001000011100010000000000100011001100110110100000
00110001011101100000100000010011000110000000001101011000011110000000001000000000001100110110101000000
10000101000101000101101010101101011101101010011001000101010010010110000000001001010011000000011000000
00001001100111101101100101000000000011010000010001000000100001001000011000000001101000000100100110100
00101000101100100011000110010011011000101000001010000100000000100100000101100001000011110100111000000
00101111000011000000000001101000100100001000000101110000101010110001001000000100000000001001110100010
11100000000010011001110011110110100001101000100000001000000010110010000001111011110001000001000100000
00001001010010100000011100101100101100000000001010010000100100100000100010101001011100001000000111000
01100100010000000011000100010100001000010001000100000010000010010010100000011000010000000000101000011
00110001000110011000110110000010010000100000010101000010000101000100000000000010110010011110010100000
10000100011010010000000010001011010010110000110111000101000000111111000000100000100000010000101000110
00100001000100001110010000000000011110100011010011010101000111000010000001001010111000101110001101001
10000000110100010110000001110001011000010110000010010001011001110000100000110000000110010010110001001
00000010000000000001000001000100100000000000000000100000100010010110000000000001001010000110010011000
00010001000011000100010010101001000010100110010000001000000010100111010100100000001010000001110000000
00000000001011111100000001010011010100000001001101111110010011011111100000001000001000011001011001101
00000010000111000000000100011001000000000001001000000110000001000010011001111011001000010100001011000
00000000110001000110000100110110000011000101000000001000000101001111100000001000000010101100101000000
00001000000010111011000010100010100000010000010000010001000000000100110000101000001100000001101001001
00110010000011010000101000110010001010101000000010000000000010000100100100111000000000000100011100000
