00001000000010100111000000000001111000000011000100001000010010010111001000001100010010100000100001000
00010000010100100010111001010001000100010010000000011000001110010000010010010000100100011000010100001
01101000101000111001110101001000101010000001000000010000000001100101100000100100010010000000010000001
00001001010010010000001000001010000001001000000010101100100000000000000100100100000011000000001001000
10001100010001001100001001100000000101000001010011000010000100001100011101000001001110001100011011000
11110001000110110000011000100001001000100001100000100011110001000000000100010011000000101010000000101
01100100001000110011111101110100001000010101000001001010000000110001000100001000000100000101001001100
11100110110000100101000101000100101010000101011010110000001011100000101010010100100000010110010000000
00101000110100000100010000000001000010001111100000001000011001010000001110000011011010000110110101001
00001100000000000100001000010010000001001011001111010011000010110010100010010001000001010001000001000
00100000001100000100110000000010001010100101000110010110000101011000010000110000010111010000010000111
00010000000000001000100001001000100000101001000000101000100000101000000000000010010001000101110111111
00000001110110100001000000000001010001100100001010100110001000101000100000000010000110000000000011011
10000000000010001011000000010000110000001101000001111001100001001001010100001100100011011010000011100
11001000100110101001100011110100001110010001011000000100000001100010101000011001000010000001000000000
00101001001101110000000111000100001011000100000011110101000101000010101100101100100000011001010000010
01110000011100000000000000010101100001100000001011000010000010001010000000011000010000000011011010000
00010010100001110101000001001111001000000001000000000001010111011000000110010010100100000001000000000
00100111000101010010101010010000100000010010011000011100100001010101000011000100000001011000010000000
10100100100001000001001010100000000010010110011001000001101001101000000010000100010001000010101011100
00000100100010110001010000100000010111010010000000000110010010010100001000000100000001000011000001010
00001000010000010000110010000110101001100011100001010000100000100100001100000000000001001010100100100
00000000000000000000100100000100011010001010110000100010110110100011111101100011010011011101000001101
10011000010110001110101101000110101000000010100000000000110001010001001011010101100000111000100000000
10000000000101001010000001000100010100000000010010001110000100001111010011000000010010000110000001000
00000000010000000000000001100011100000000000101100000000000000000101000010100111000101100010001000001
10010000101000010010000100110000010000000101001010101001011000100010100000000000111100000000111100100
00110100010000010000010000011001010100010000100001000000101001100000000010101000001011001001100100000
00000001110000100100100100010000101000001000001100000000001000000001011000100000001010011000001000000
01000001100000000000010101001001000100011001010100000010011000010011001110100000000000000001110110001
00000111001000001100000000000101010000000100001100010001001110000001100001100100010100100111010000010
00010010010110101010000001100100111100010100100000000000100101010000000101001100011010000000000010100
10000001010000101000011000001010000000000010000000110100000000001101000101000010010100000011000000000
00000000001000011110010000000010100111110111010010110101000010001001110000000001100010000111010010101
01000101000100000000000111101000100100000001000000100111100000100001010000001010011001001100000110000
00000101011010100100001111000100011000010010001000010000000111001001011010100000100000000100011100110
10010100010000010000010000001010100100100001000011100000000010000011001000010000010000011001000100100
10100010000010100000000001110000100010101100000001001000001000000001000110001100000010001011110000011
00000001010101000010010000000000001010110001111100000100000010100000000110000010100000011000001001000
10001101000001011101111101000100000100101010001000000000010010101111001000000110100010111000000100000
01010011110011110000100111100100110001000100000001010110000100001100001001000000110000100000000010111
01000000100000100000000010000010100001101110000000011001100000000010000100010101000100000011110001100
00000001100000010000011000000100010000101111000100100010100011000100010001100000010000011000001100010
10001001000101000000001001000101000000100000000100010000001101110111000101000000010000000000110010000
10000010010010011000000000011011001011001000000000100101011001000111001000100001010100000000110001010
10100000000001010000101010000000101001000000000100100000000001000010000010011101011100000010000000101
00001000110000010100010101000000001000001100100100001110000101110110000000011000000010110000101001010
01000000010011100111011100010000010000000000000001100000110000001100100000000001000100000010000110000
01100000001001101000001000000000010010100010111000010000100101001000000010000010100001010101010010001
10100010001000000000001101010000000010000000001001000000000101000000110100100000001001001010000001010
00000011000011000000011001000000011000101110000000010110101100000000011101000000100100000000100000110
01001010101000101000100000000000001010010000000101000110000000010000011101110011000010001100100110000
01001001001011000000101011001101100000100101000000000110100100001011110011000001010001001110011010100
00111000100010010100110000010000110100001101000100000001000110000110000010000001100000100000010000001
00100001010110010011100101100001000001000000001010000010000100100110111010000000101000001011101110011
00000101001000010110001000010011000001100100000011001000001000011001010000001001010110001100010001000
11010011001000000010000001010000001000100010100001000001000000000000000100100010011101000111000100100
10011100000110000001100011000000100111001000010000010100000111000010110001000000010101100101000000000
11001110100000000001010000101100110000010000000100000000101000000100110100110000100011000000000000110
10010000000000010000011101011000000000001000100101000011000100100000000111100000110001001100001000100
01010100001100001000001000100000010010000010000000101000000011000001000010000000000011100001101110000
00100000001001100000000010101011000010000001101111111100101110100001100100010001110000000000011111000
00100000010011000001000110000001101011100000000010111100000110001010110000001100000001010001010000100
00101000110000010101110000010011011000000000000000000011010100110001000001010000001001000001101010101
10011010100011000000001000010000010110010110001100001010000010000000000010010010000110001000001100010
00010000010000100110111101001100100011000110110000011100010000000000001001000000010000101000001000001
00000000011000011010000001000101000000010011000001000100000000011110101011010010000011000000010000100
01100100000010011000000001100001100100100011011011010010001011000000111010011001011100000000011000001
11001110001000001110000100000101111000110001000000000001111000000110111000100101111101101110000010101
10000110000000101001000000100010100001011001000010000010000111000101000000011010010000011000100001110
10000101010100011011010100000010011000100001010001000000100000110100100010110001010000000010001000001
01001000111011001100010110010111001110101100100000010000001101000000000000110010011110011011000001000
10000000000000100100100000010010001001000100010100010011000101010000000000000010100000011000100000000
00010000000101110000100001000000001001001000000001000010010010001010010101101000001100000000001000011
10000010101001001100000000100010001100000000011100000000001000100100010001001011000100001100100000001
00000101100000011111010000000100110000101010000000001011000001000000100010000001000011110001000000000
00010100000010001000100010011100000000100111000011000101111101001010000001000010001110000000000010000
01000011000100000000000010010001000000101100100001000100000101000011001000010000000100010000010000111
01000010000000011100100010000100101010000000000000010011010110000000101100000000100010010000010010110
10000000100010000110000100101011010000000101011010111011010010000000110000101001111011010000100010111
00000010000001010001000100010001100010100010100000011000111101000101000101000001010010010000000001100
01010000101000011001100100111011000000010010100000101100001000101100110000001001010111000001010010000
00110000100000000110100100000001000111011011010000000100000000001010101110000001000000000010001000001
00000010000100101100000010010000000100111101011010000010001000001001011100100011000001111100101010100
00101110101010011110100000110010000000001001110000001001100000100000111011101000000001000011000010010
01011100010000000000100000000000100100101011000010000010001001010000100001100001010010000011011000000
10000000000000000100010000000001000100001011100100001000100000100001111000000010100100000111000000010
00110111101000010010001000110011101101010000110010010100100010000111000001100000010001000010000101010
00110001100000010001000000101010000100000000000011010000001110010011100101000001000011110000001101001
10000110011110100000001010001011110010101011110000000011000010011000011000000011000010010001010000101
11000001100000000010000101000100101001100000000100001010100001000010001101001000111000100000101110000
01011100101000100001001100000100100011001100001100011000000100001100000000100010101000010111001001011
00011101100101000010001111000011000100001000101010010100000101110110000010010000001000000000000101000
00000001000000001100010100100010101010000001110100100000110110001010000000000001011100010100101000011
11001000000010000001111110001100000011100011001000101001110000011100110001100000010010001100010010100
00000100000111000001001010010011101000100000010000000011000000101000100000100101101100000001010110010
01000000001000010001101001001000000001000001110000000110010000000000001100101011010110100001110000100
10000010001010001100100001100100000001000001110000000010000110010101000000110010000100010100000000001
01101000000100110010010010110110000010111000010000000110000000000110000000000010000000100101110010000
01010100100010000010001000110010011001100001000010000001000001110010110100011100000000010000000010000
01100100000001000001000011010001010110110100000111000100101000000000110010101010000011000101000010010
