00100000000110011011000100000100011001100000110011001000000011000010100001010110000011101010111000010
00110100100000101000010100110000010000010000100111000000010010001111101110100011000010001000000100001
00000100000000001011000000000100100110010000000011000000100000010000100001100000011100110001001000101
01001110001000000000001000000100000001000100100000001110000101000010000000010000001100110001000000000
01000000001101100000100100000110000101000011001000010000000101110000011111100010011011001000000000000
00010100111100010010110110100001000011000100000101001101010100010101100110001010000010000100000110010
00100101010110100100100000010001010010110101010000000010100000000001110010101111101100100000000000110
10010100010000100000111001110000000000010100110000011110000100000101000000010000101110100101000000100
00110000000100000110101001001010011110001000101000100111100001100000110001000011000000000000000101000
10000010000000001110000000001010100000100001000000100000000101011001100010001000000100000000001010111
11001000001000011001000010110100110011100110010000010010010001100000100010000101101100111001000100000
00010000001010000100001010000001000000000000001010010000111101100000000001100000000111010000001000000
00011010000000011000000000000010010000001010001001000001000100001011110001001110001100000100001100000
10001010000100001001011011010000101000010001010011000000011011100000010101000100000000000100000000000
00001001000001111011100010111000000101000000001000100100001000010000000000001000000000000000010101101
00100001001000000000010010010001100000101000000001010000101010111000110010000000000001100100101000011
10100100000001010100000010000000101010000000000010001011001001000000000100000011001100010000111001001
01110011011000000000011000000000000000101011000000001001001100011000001010001000010100001010000100101
00001000000000100100010010100100000101101100010001000000010010000000000000010000000100000000000000111
00100000110100100010010101000001010000001110001000100000100000010100010110000101000101010100011011000
01100101010000000101010001010100110000000001011000110001010000000010001011000000111010000000101001010
00011000000010010001001000001000000000000010010010001000010110100110000111000000000000110000010000110
00000010001001010011010001011100100000100010010000000100010010010010011000000100000110110010000000011
00000010100000100000001011010110100010101110000100010011011100000000000001001011101100001100010010110
10110010000001011010100000001010011011100110000101000101000010101110010001010101000000000010101001010
00010010100101101000010010000010000010000011011010001010000000010010000010100100000000100000000000000
00001001001001000100000000001000000000100000000001011010010000001000111000010000000100010000000110000
10010010000011000000110000010010101110011001001000010110010010001100101100100000111000000000011101000
01000000111010100000100111000100001000101010100010010010100010011010000000001001010000100000000110011
10000010010000100000010011000100110101001100100000000010000000100000100000100000000000100000000000001
10010101001100001010101000010100100111100100100000000000000110000100101100100001000100000010010000110
10001100010100100011000000100100100010000000010001100000010100110001010100010110000000011000101000001
00000010001000110100100000000010111110000000100000010001001010000100110110010110010111001000001100100
00010001000000001101000000100001100000101000000110100101010010001010111001010000011100100000000000010
10111100100000000000001001100101101110001000100100000100001001111001000011100010100000000010101111000
10010111001000001001000000000001000100101010000101000011100100010101000000001001010001000000011000100
01010110001001000001001100000011101010010110001011000000010101010010000000100000000010110000001001000
01100000101011001100000100100000000000000000010010000010000001011010110000001000010001101000000100100
00101000111001000001110001000001010001000000000010001000110000000000000000110010001000000010001010010
00101100000001000010001100001001000000000100001000101100001000000100000001010100110000100010000000000
10010110100011001010001100110100100000001010101001111101010000000001100010100000000001010101100000101
00010010110000000010100111000000100100100001101101100000000000010101001110100000010000000011001110100
00010000100011000011100001001000101110000000011011100000100000011111100001001000100001110011100010100
01001011000001100111011000100000000000001000000000101001100001000000100100000101000001000000001000000
01000001100010100101000000100010010110010001110010101001000100001101100110010100000011100010111100010
11100010000000000000000010110000011000111000000000000001001010010010000011000000000111010010000000011
10011000000001011010010100000010100100011101001010111000001100010010000100100010110011010011000000010
00000010001101110011110110101110000100000011010001000000100010000000110000000100000100000000000001100
01110001010000100000000000010011100000001001100010001111001001000010010010000100000011000000100100100
00001000010000000000010100000101001001001101110100100000001010010010000000000110100010000000000010010
00101000000000101011010100011111000000111000000101010110101001000110010001000100010100100001010110000
01100001000111001100100001100000010011100000010000010000000111001000001001101010000001000111010000010
10001101000000110001000000100000000010000101100100000010001001000111001010100100101100010010001010101
00100110100011000000000001100011001001011010110010101001000100110001000000111000000000100000011010111
10010001000100001000001100000010011100000000100000000011100100001101000110110001100100000010000111000
00100100100000110010010010001100010111100000000001111100010010101000010000011000010011011100110000010
00100101000000111000001000010000000100110010000110000011010100101110001011000000010100000111000100100
11010100010000110110111100001111000001010001000110101000000101000110000000000001000000000010000010011
10111010110100000001000110000010111100110000011000000000010000110100000111101000101011000010100100010
00110000111010100000010011101000101110000000000100000001010111010000101000000000100000000001100000010
01101010000001010110001000000111000100001000110010100010101001100001000011000110000000001011100100000
00000010000100111010001101010001010111000000000110101001100000000101001100000010101100000000001010011
01111101000000100101000001010001100100001000001000101100011100000000000000010100000101010000011100000
00000100110011000000000000010001000010100000001101001001110000000000001000110000001100010101001010100
00010000100000001000101100000000000011010000000011000001010000110000100000001000000000111100000111000
00010010000110000100010110000001100110001100100100011100000000000001000001000000100001000001001000001
01101010010110000001001100000100000001010000000001010001000100000110000100000000100100000100110010110
10000000101000100000010110000010000000000111000111011011001010001001001100010010000000011000100001100
00001010001000010001000010011101000010000001100100100010001110000001000100000001100000000000101000101
00010100001000100011110010000110100110001011010011100110010100000010010100100000000010011100010010000
10100001001010010110000101101010000110001101000000111010000100101000000000000000100000010010010000010
00001110010000000100110000000101000010001000101011010000001011010000000000000000000001011100010000001
00010000000110100100010000100000000101000000000000000000101010101011000011000001100000101000000000000
01000110010010001000010100000000110100000000000101100000010011010010100001000000010000010101010100110
11000000000000000010100100000000000001001010001000100001011100001000000010100110100010010010100110000
10000010010100000100000100111100001000010010000000000000110100001010010000001000100100100010100000001
10000000110000010110011000000101000001001010000000010001000111001010101000000000010001100010111100100
00000000110010010010100100010000100101001000001100101000000000001000011101000001100000110100000000001
01010000100010101000000101000001000000100100000110000000000000001000000001010000010100000000001010100
01100000000000000100001010100101000001011001101000100000001001000000000000001010000000110010100100101
00100000010010101010100100000010000010110001011000000010000101000010000000000010000100101010010000000
10000000010100110100001000001100000001000000000001000001100001000000100011111000000000011000011100001
00001000101010000000010000000000101110000110000011000111001000000011000001000010010010011000000010100
10001000011101101001001111000001100000000010010010000000100000000110011111000101101100000100001000011
00010110110110110111110000010100000010111000100101000001001000001010010001010001000011000101110100010
00101011001110000001011001010010101101000011000100000000010001110001001000011101101010010100110100001
00000000000000000110111100000110100001100000000001010000000111010101010100100101011100100000000100100
00000000001000100110000100101000100010010101100110000010010100000011001010000000001100001111111110000
10001001011001000111011000111101001100010010000100001101000001000000000000000110001001101000010010100
00010011000000000100000101010001000010000000011101001101001000001100000000110000110111110110000000001
10001011001110000000000110000100111010000010011010000001101100000101000010001000000000100000001100000
01000000000000100010100000101001111010010100100000000001000010010000000001001000100000000001101000000
10101001110101001001001101000000100011001000000000000001000100010001001010000100001110011000110000000
10000100000000000000011111000010111000000110101010000100001000011000000001001111000000001000000000010
00001001010000000000000001001010010000111100010110010011001001010100001010110001001011000000000000010
01011001000110000001000000100000011010001000011001001100000001000011011100000010101000001101111100001
00100100001100000101010000000111001011110011001101000010010001010100000100110000110000000001011100101
00001100100001110000100000100001011000011001100100010000000101000010011001111000101011010000000000000
10000000011001010101000100001011000010000000000101011000011100000000100101000101010101110010101001010
10100100110000000001001110001000100000000000000001001000110100010001000001110110100100000101000000000
00000110010100100000000000100110011000000111000110111000010001100101010010000000010110010100010001010
