00010100000000000100000001000111100000100000100000001110111011000000010001010010110010000000000001000
10100000010000000010000001011000001001100000011001010100110001000011110100001000000000011000011000000
10011110001010000010110001011000100000000000000010001001011011000010100010000011011100001000000001101
10100001000010100011111110000100001100010010101000011000000100010100010001001000000000001100000100111
00000100000000001000010010101011010010000000100010010010100100000010010000000000011001000010001000000
00100010100010000001000000000011000011100001000110101100100000000011011101100000000001010100010000101
00011000010000001000000110010000100000001000100000001101011100000100110110000001000011101000110000000
10110100000001011001100001100100101110001001011100001010010011010101000000010110100101100100011000000
00000010111101100001011000010000000001000000100100001000001101000010101000000000000000000010100000000
00011010011000101110100001001010110000111100010011000100101010000000100110010010000011000000100000011
00100000011011101100000000000000010010000011000000001000010000000000001101001001000000100000000010001
00011110000000000000000100000000001000000110001001110000000000011000010000011100001110000001000100000
00010000000010010101000000101110000100011110101001100001100000000010100001000001010110010101101000001
00001100000000100100010000000000000100001100110100000000101000010101000000010001010010000010001000000
10000000010100000100000000100100010000010110001001010000010110010001001001010100000010100010101010000
01100010000010000000100100001101000010100000000101000000001101000001000000000001011000100110101000001
10000100000100000010000010110000110000100000101110001000001110000010110000100101101000000000000101101
11100000100001110101010110110101100000000100011000100011110001011011001001001001100100000010101000100
00010000100001000000001000010000000001000110001001000100000001010111000000100011000111000001011100001
00000000000011000000110000000011000100100001111000110011000100111000000010000001000100000001100000011
00000011000010011001101101000100000001010000000100001100000000000000000000000001010100001000000011000
01001010100001010000100001011000000001011010001001000100000011000101010010000110000010100011000011010
00000000100100010100000000000110011011100001011100000011100000100011010000111000000010011001000010000
00010000000010000110000000000010001010000100110000100001000110000100010001000110000011011000000001110
10000000001000101010110000000010011000000100001010000001111100001110000100101000010100011100100000000
00000100010011111001000001001100110000000100100010000100100100001101000101000100000010110000110100001
01010111100000011000101011100000000001000010001000010000000100011101000110000101110010001101001000110
11000001000100101110101010100010000001001010010000000000111001000101000000011010100010001100000101000
00011101101001000001110010000000000001010000001000110001000100100111010100010000110000010100111011100
00000000000000010100010001111100001011100010111000110011001000010100010100011100010010010000001000000
00010100101100010010100101101101010000100001001100010000001100000000000100011101100100100111001001000
00000010010001100000000100100011010011000101000000000000000000001001111001011011011101000101100001011
00000110101100001000010101010111101000001000100010110000001000110100010001010001000010001010011010000
00001000000000100001100000110010001110000011010010010000001010001111001010001000001000101100100000000
00101100000000001001001001100000010010100001001000010000010011010000100100110110100100101010000010000
10000100000100101000011000000010010000000000101010010011111001110000111101010000001010011110001001100
00001000101011100000011000100010110000100000100001111100010000001000100111101101110000010000001000000
10100000100000100000010011011000010010000000000110100001100101100000001000010010010101100000000000000
00001010000100000001001001000101000001110001100011100010110011110111010000000000000100110000001100010
01011011011110011000110010010010000000010000000100111000011100000010110001010010001110001011010010000
00100000000110000001000001001000000001000000001111011010000001100010101100000001100010000010001011001
00110100000011001010000000100010001000000000000010101001110000110001010000001011000001010010000010011
00010100000000010000100010010111110101000000110010010010000000111010100001100000000000001000000100101
00001101011111100010000010000001001000010000000110111010110100010100010000000011101001000000000011011
10000011001000110100111001001100000001001000000001010100100110001100001100100011000000000100001001110
00010000000000010101000000000110010100000101100010010100001010001110010100100110010000010000011111100
00101010101010101000010000000100010000000010000001010000100001100001100001100000000000101010000001000
00010110000010010010100000000001000011011000010101010000100101010001010000100000011000110100100001001
01000101100000011000000010100000000110000100000010101110000001101000111100000010001000001000010100101
00000000010010001000011110101100100100000011100100100001110000001000000000001001010100010101000001000
00001000000011000110001110010000100000100001001001010000100100101100001000100000010110000101000001010
01000000100111000110100000011100001110000011011000010100010100000000000011001001010100000001000000011
00001011000001100110101000010010110100110001100110001111011000010000100010000000100000011110000001010
10001110000110000101000000110001011101000001100100011001000100000001001000010010000100000111111110110
11010010000110000001010100000100010001101000010000000110101000001101110100100000110010001000100101000
00000000000001000000010101011100000111000001110101000100001100001110000000000000000100001001110000001
10001110110010001011100001011101000001010000010100000110010011010000010100000100100010001000010001011
00000011001110110110010000010000100000110100000000101010010010000010010011000111001010100010101010010
00010110010000001011000101000000010010000100010001010101100100110000011010000010000110001010001010101
00111000100000011000000111101000100100001101000000001010000110001101000000000101010010100110100000000
00001110111001101001100000100010100110100000000000100001000100100001001100000101010001011001001000001
11001011000100000010011001010000010000100110110100010100001000010000000000010100010011000010011000000
01010001000100000111100001000000001000100001000100001001100001100000100101001100000000000100001000010
00000000101001001000000001100010000100000101000011001011000000011100000000000100001001100010000001100
01000000011000110010001010000100000010010000100010101010100010000101100001010100001100100000011110000
10110000000000000001000011110000000010011000000000100010110100001000000011001100010100100100001100000
01000100010100000000010000000010001011100101000101100100000000000101100010001100001010000000000000100
00010000110100010110100010010010011110001100000000000100000000000001010001000100101000000000100001000
01000000001100000000001110000000010011001000110010100100001001000100111000000101110100010110001011011
01010000001100010100000010000001111001000011110000011000101101100000100000001100000000110000100000010
10000000010100000001010001001000110000100000110010100000000010000000110000010101001101001100010001100
00000011010000110000000000001010100011111001100100001100001001000000110000011000110001000110011010000
01000100100101000001101000000100010001001010010110100001000000100010110100000001001000000100000000011
00010110001110000000000100010100010000100001010000100010000010000100000000110100010000010101100000011
00010011001001100010001000110000000010001100000001000000001001101110000101001010000100010010100000101
01100110001000010101101010010010000001001010000100000000010001010010110000000110000000010101100010000
00010111011000110010101100010000010111010011000000001001110000000010110010001000010000000100000010100
00101000100011101000000000000100000000010000000000110100000010000001101110110010100000010011001001101
11010000000011000001100110100001110011100000111011010010011011100011010010001000001101000100110000000
00000010001101000000011100011011000011011001100000000100011001001010110100011100000010100001001101010
00011010000001011111000000011001000000110010000000000000000001001110000100000110000100000100010001111
11000011001101011101000001010000001010001000100000000000000001000000111100000011100000000000000010101
10110000010000100010000000001101100000001011001100100000000000100000101000001100010011001110101001011
01110000010000000000001001010110000110110000010001001000100000001000100000000000000000001110011000000
01000011100100001000001000010000010001001100000111100000000000010101000100101100000100010001001011010
01001100100000011000100011011000000010110010011000011100110001001010000001100000010001010001000010001
10010000100000001000000001010010010000010000000000000101000000011101011000010010010001001000110000001
00000000000000110000000100011000000011100101011010010000100010011010001000000100010001000001100010010
01010001000011000000011010100001001001000000011000000000100010100000000000000001001001000001000100000
10100000110000010010100000100001010010000000010000000110111100000000110110000000101001001001010000000
10100001011001100000011011000110101100000000110111000001000100101111001110000001000010000011111100001
00000011000101001000110010000000110110011010101101000000001100001001001001000011000101010100010100000
01010010000000001110011000000010010000000001100000010110000000000101001011101000000100001001010101000
01001010000110000000110000000011001010010000000100011100000000000000010000000010100000000101100000100
00101010000110000100100001100100101000000111000000000010111000000110100011000000010101001111110000010
00010000110001010000010000000010011001000100101000100010100000000010011100010001000000000000100100100
00110001010000000000010000001000100001010010000000010001001000100011000000100000000001000000001000010
00001000100000111100001001001001010000000000000001000100001000001100001000000000000010001000001100011
10110001000000000001010010000000010100011001010000000110000100011101100100010000000010100000110000100
00110010011100000100010001000000100001000000000001000010001001010100101010010010010111101010001100001
10001100110001000100011011000000100010011110001110011000000100000001000000010110000100000001010000100
