00001100110100100110110111010100100000100100010000000010100001011001000100000011101000000010000110000
00000000110001100000100101101001000110000000000010000101000010000001011110001000100010010000001001000
00000000111000100001000000100000100110010101010001010000001101100100010001000101000000011011100010100
01100101000100001110000010001000000010000011101000011000001101100000000000000101000001111000111001000
00101100010001000100010010000001010001001011100000100000000000000000010100000110100011101010010010001
10111101110000110010000011000000111011110100010011000001101000010000000000101101010000010000010010001
01000100000001001000001001010110001001101000100011000101100001000100000011001000010100010001101101101
00000000000000000001000100000010100000000000001000001100100000000000001001100000000000100000010000000
00000001001101011000010101000000011101101011011000000100010010000011000000000000011001000100000000000
10000001100100011000000000010110000001100011001001010001111001011100000111000010111001110100000010001
00100010101100000101101000010110000100111000101100000110000101010000000100000001001001101100010010000
01101010001111001000001011000000010110101001110010100101110001001110001000010000011110000001100001000
11001100001000000010010001100011000000000110000111100010010010001000100010010001100000000111001001000
00010101010001000000010000100001110000011000000000010000000000000000010001100001001000001001101000011
00110110101001000011100000000101000010101010001000110001001010000000101001000100001000000001100000010
00101000000000001000100101000000100000111010011000100111000010101010110001010010001111011001111000000
01010000110000000001100010000000010000000000100000100000100001100000101001101000000110100000000001101
00011001010111100100001000000110110000110100100000010100000000011000000000000010011110100011100001000
00001000100001100010111101111000001001000101000000001111100001001101100000001000000000100110000111000
01101000111000000100011111001000001000000001000011000000000110011000000000000001000110000101000010100
00000010010010110000111101000010010100100010001101111000000000100111010000110101000000000000100001011
11111111110000010010100010011010000010001110010100111000000100000100000000000000000111010000100000000
00000000101000000010010010100010001100011010010000100001010011000010100001000000000000010000001000000
00000001100000110000000100010001000001010010011011010001100000110010000011000101001001101000111100000
10100000010100110010010010001000011001000001010001010110101000000110000010000001100001010000110010101
10000000001011000011010000000100000001000010000100111110001001100000010001100110010001000010100100000
00000100000110001011100001000100001100001111001000000111000110000010100100000000001100001011000111010
00010000100110000111000001110100101101000100010000000000100110001000100000100001110110010110010011110
00011000011100010100010101010000100000010101100100100100011011110101001000000101010001001000001010000
00101000010000000001000000010001000100110000000000000000000101000010000000000010100011000000000000000
00000000000000101000101100100100000010000000010010001101001010000000000100000000001001010100000010100
00101000011100001000000100000000111100100100111000001001001001110000100010001110000010000000100001000
00001011100100100110000010100001100101101010110000000001000010001100100010000010000101000000010110010
11000000001000000100001100000100000010000000000110000000000100110101000001110110000001000001000100101
01100000100011000100100000000000000011010101000000010000110001010001101001000010000000001000000101100
00100000100110100010000000000100100000001100000100000010010000001000110000000001101011010000000100100
00000100100100111101010100000000101100101000001000000000100100010000000000000011010010000000101000000
01100000000010011000000000010010000101000101001000000010010100001001110000011010010000000100000000001
10011000000000000100001100100001000100001010100001001111000101000110110000110001101001011010011011011
00100000000000000000000100010110010000110010001100001000110000000000001010110001100100111110010110000
10000000101000100000000011001100000011100111010000100100100001000000000001110110010100011000000001111
01000000010000100000001001000101000010011000100000100010001000000010011001010001110010010100001000011
00100000000000110000110000100110001000000000011000000010101000100001001100010011000111010100011000110
01100110000100100001001000000001001000001000010011101100001110011100001000000101001010100000010001000
11000000111001000100010000000111010000000010010001000100110000000000000101100011000111000000010000010
01011010000011100000000000111000000011000011111100010011111100000000011000010000100000001100001100001
00100100000010000000001011011001000000000010000100101101000001101100001010000010000000100001000101000
00010011000000000101010000001101011000100101001000010000001000100000011000010001101001010111000010100
00000111110001001100010010001011101010000100000000000100000001001011000001010010001000100000010000001
00101100010000100001100100111101000000010001100001001000001000101000011000000101010000001010000100010
00000000000100100010000100100101000111100000001001011111001000000101010000111100100100001001010010000
11010000110000001010011110000000111101100000010001000001000100001010000010000100101110011100110010000
01000100000000100000000000000000000010000101001110000000010001011101001110001010001100001010100001010
00101100000111010000010110000100001001011000000001001000001000001001010010000010010001110100000010000
00011000011001000000001000100011100000100011100011001000001001000000000100011000011000000110000101000
10001000011000001101000100100110000001000000010000001011000010001000011010001000000111010101001100001
00000100100000011100000000010001001000000110000000000000010101001100001101000000010000000011001000000
11101010110001100111000110000100001010010101110000010100000001100010100111000101010000101100100000111
01100010010100101010001100010110100001000000100001010100001000001101001010100001000000000000100010000
00110010010110001000000000010001001001000010101001001000000001110001101011011100010000100000001010010
00100010110000000100101001100000101001000110000000000011100010000000000001000000100101000100100010000
00001010000001010100000100001000000000000100001000000011001100000100011001000000000000010000001010011
10010000110000000100010001000100000010011100110011000010100110100001000101001000010001000000000011011
00000000010100101000000010001000110001001000110000000010000000000111001000000001000010001011100110100
10000010000011000000000111001010010111000100100101100000010001001010010001010001000100100011000000101
10001100001001010111100000100011001100001000000000001000000000100100000010000110101011011000000000100
00001011000001001101001011011011110010000001000100000000000000000000010011100100000010001001011101100
00011111000010100111100100000000000000001001000100000010001000100000101000000100000101010110010000001
01000000011011001000001011000000100000000100000110000001100100000111000000001010000000000100010110100
01010010111001001000110110001001001000100001111011001000000000011100011001100101001100010110001100110
00001100111010010010001001010000001011010011011111011111100000000010000110000010101000010001101000111
10011000001010001100011000101010000001010100000010000000000010010000100111000100000001000000001110011
00011011110100100011000001010001000100110010100110111100000100101000000011010111000100000000110000100
11000000110010000000000000010000010000000000001011001000000001000111101001010101000100110010001100000
00000111100101000000000010010010100010100000000000110011001100001010011110001000010001000100000000000
00101100000001101000101011000010000000010001000100100110011000011010011110010001100110011000010010000
01000100000000001000001000101101000100100001000110000101001001011000000110001000100000001001000100000
01100000100110000110011010000000000000010100000001011010010000011100001010000010000100010010001000010
10011000101011000000000000101001000000010000010011100000111000010101101000001001101000011000101000001
10011000100000000000110000000000010100010000000000010001000000100001000001100000000101001110011000010
11010000000000001110011101000010111110110000100000100001001100100000111010000101000010010100100010010
00000011000001101010110000000000010001010110010000010100001010010000011000000010000010011100101011110
01010110100101101010100111010001010100001000100010100100000100100001100000100111011000000000000100000
01001001010000000011100100000101001000001100001000110001100000000010010011110100000111000001000010000
00000001001000010000000011000000101110000000000110100001011011100000000011110111100000000011111000010
01111000100000001000000111100100100110000000000000001000000100100001000000000000010001000000110000011
00101011000100000000010100111110000001111100000001001110011001110100100000000010000000000001100001000
10001000000100000001011110000111000111100000010110010000000000001001110001001000011000000001111110001
11011101001100010000000000000000000010000100000000011100000010000001000110011001010000000010000000000
11010010101000000100110101010010110000001110010010010100001000000100110001000100010000000000010000100
10110110001100001000001001001000110100000000110010010000001100011101101001101000011110000011000010000
01110010000000000111001001110111100000000001010100000100100101000010010010000100000000111010010001010
00100000110000100000101001100000100000010100000101000100000101010001000000100101000100000000001010001
01011000001001010000011000001110000100000100110010000100010000011100100101000000000100000111011001110
10011000100000001000000000100001001000011010100100000000111000010111000001001000111000001000001010110
10011100000010000110001100001001000010010011010010000001000000010100000010000000000000111000010000000
01000101111100000010000010010000000110101010001000101010000100000000000000000000000100010100000001001
00010101011000001111000000100000011010100000100000010001001101100000010001000100000110001100000110000
01000000000010111000010011010000000011001000001011111001100000000010010101110000110000101110000111000
10100110010000110100000000000001001001000000000000010100000000001000000010001000010000010101110000000
00101100010000110101010000000001101000101010100101000000010011000000000010000100010101000000100010110
