00001100010000001000000000001000100010000011100010011010001011011001000000000011100001010010000001111
00000000100000100101001000001000011000011100110101010000110100100101111000000000000011011101010000001
00100001000011000000001000100010101110101010100001010000001010000100101010001011100000010000000010100
00001000000101100000101000000110001000100000011000010001000001000011000011000101001001011111001010010
01000010101000001000100000001000010000000001010101010100000101011000000010000000001011001100010000100
00001010100110010010000010000110001110011010001000011100000000001011010100011001000010000000001100010
10101000011010001000101100001010010011001010010110000000110001001000100011010101100000110000000100000
00100000000000001110000111100000100000010000110000001011100000001010010101010001100001100000001010000
01110110110000000101001000000000010000000010000111110000000000000000010001000000000000101000001001000
00010000010000000000010000011000001011101001101000001001110110000000100100010100100000000000000000000
00011011000000001100001100000010100001000001010000011110001000001010010010001010001011000010100100110
01001010010001100100000011100000100011100110100000000110000010000000100000000001010000010100001000010
00010000100000000100000010000101000100010000010000110011000111100110000010111010000000000000001000000
11010011100110001001111110000000000010000011111101000000100010001110110010011000000010001101000100100
00000000001000010101011000010101110010001110000111001111100000000010000011000100001100001001110101101
10000110010000000000101001100000101010000000000000010100101100101000000001000001100001111000110001001
00001000010101000001011110010011000101010101000000101010100000110000101111001001101000010100000100000
11000000100000000000001000010000111101001101101001111010101011000101101001001001000100000000000100001
00000001101001010000000101000110000110011101100000010010010011000001100001010000000010100100101000010
00110000000001100000110110010011010101001110001000001100110001101000001110001101001110100000000000111
00000010000100100010000000010000100110000000000000000000000011000000001010000001100000110000100000000
00010000011001111100100000100010001101111000001001000000000001011000000000100011011001100101001000100
01101010001000000010100000001100000110100001100101000101000001000010000000000000001000100010010001100
00111110000000010000000000000001000001110000100000000010000001100010000000001000001010111000000001100
11101001000001000000100000001100110010101101011010000000100100000000011010000010111001000001000100000
01001000110001101000011111100000010100010000000010010001010010001010010001010010100000000001000011000
00101000000000010001000110001010011001010000110111001111011001000100001100000101101000100000001010001
00000010100010100100000010100110011100010100000000010001100100100100001100111000100100100000010100000
00011000001000011000101100110010000001010000101100000000000110000101001000010100010110110001001001001
00110000100000010011000001011001001000000111000011001000101010010001010100110101101000100110110100100
11000100001001000000101000010110110011000000000110000001010000100000010000110010010101001000000000110
01100010101110000100000000100100000000001011101110000000001100000100000110010000100000001100011000100
10110100111010100001000000011001010000000000000010010011000010000001000001000000000001000110000000100
00101000100000010010000001001011000100000000001100000110010101100110101000110000010101101100000000010
00000000000100000000100111001000000010010000000010100000001101001001011000011111110010101010010000110
01100000111010000000110000001011000100111000000000010100000001100100000110000000000000001000000001100
10101101010001010000000011001000111000001100011000001000001000100011110000100100001001000110001110000
00000000010000000100111000101001000100110010000000101001001010000111000000000000000000000000010000010
11001110111000000101000001000100000011100000001110100010010001100100100111000000000010100010000010001
10001000001101001010100110000010100011000001010110100000101000000000001001001110000100100000010000000
10000100010101001011100110010000000010010000100000111001000010001000111010000000111001101000001000100
00110111000010000100100101101010000100000000100010000100000101000011000000001000000000000010010101101
00110010000000001010010000110101101010001001100000010000000001111000000111010010001001111010100010010
00101000101101001100000100011011100100100010010000010000000011000010000000000001111010000000100010000
00010100000100111000010100001100010010111010001000000000000100101001100111110100110100000000000101111
10010100000000001000000000100000100001000001000010000000010001010000100000000010000000011001010101001
01001000001010000000011000010011010010000000111001100000010000110011100000100100010100010100000000011
10001000010010010111111110100100001001011001110000100110000011101110001111100000010000110000010000000
00100000000000001010010000010000110100001001011100010010000000101110010000000101000001000011100000000
00000010000001110010101011000110110101000110001000001010000011001001000100010110010000000000011000001
10100110001110000000010010111010000001010000001000100010100000100000010110000001100010111000111000000
11001010100100101000000100000010010000000000001000100000000010000000100000001101100100000101010010010
00001000010000000010100100010110000011100000000110110100101010010010100000000001000110000000100011001
00001000100001000010000000000101000101011000110100001001100010100110111000000000001010001111100010000
10011000010000001000100010101000011001000001000000001010100100000100000000010000000101100010001101001
00100000000000000000000001000000001000010010011001001010000110010000000101010000110000101000001000000
00001100011001010000110000100000000000101001010101010000101011100001000011000100011100100010111000111
00010010000000001001000001000000001000000100000001000001000001000000000010010100111000101010000010101
11100100000010001100000100010100110000011101100000101010100010011010101011101110000100100001000110101
00110100000100000011001000101010100110100010010101100010011000000001000010001000000011100101100100110
01001100000001010010010101001000001000001110100010100011000011000111001101111100101001000010000000001
10010010100100010101101001000000011000010000011001010101000010001001001000011000011001100110100001010
11110000001000000100001100000111011000000001100010000110000110110100010100010100100101001110011100000
00110000100000100010000000100011101011010000000110100000001010010101101100000001100100100000000001100
00001001000000000010000000100000000010000011100101001001000000111000101010001000000100001100110010110
10000001000101010000101000110010000000110000000100011100000100010001001100011000000010000100110000010
00001101011000001010110101000000100000000001000010011000010000000000000100000000010110010000100100000
11111100010000000001000110100100110000100000000000101111010110001001000100000001001000000101000000111
00010000000010000000001000000000000010001101111100011011000100110000001100000110101100100101100001000
10010100000000011000001000000000001000100000000001000000010000000000011010010111010011111001011010010
11011110011101000000000101000000001100000010111000001100001000000010001010000010001000100000001001000
00000100010000000010010001000001000100110001001011001000000001001000100010000010100100000100000001100
11001000001000000000001100101000111000000010000001001010100000000010011001010000100010100000100000100
01000000100001100001010000000101000011000100011100000000000000011110110000110000101000100000100100000
00101111010110001100001001000001100100000010101110000111001000000000010110000101001000011001110100101
11010000000001001100000001001010000101000010010100010001000100000000100000000001101000011100000010010
00001011001000000010000000000010100001000101000100000010000001000000010000010000011100111100100000010
00001000011000000001001110000101011001000000100001000110011000010000001100000000000110000011000010100
00110000000111010000110001110010010011100100101000000110001001101100000111110100001011011011010000000
00100000001100000100011011100001011011010000001001111001101110010000010010100001000010100000001000000
10100000000000100100001100000010000100100010110001001011011100000010001110101100000101110001000000010
00001000100101100110010000010001101000001000101000001101010001000100000100010101010111000101100000111
01011110010000001010001100110000000101010000010000000101101101000011100101000001000000000010001010101
00000001100000000000010111000100100111000000010000010010000010000000010010000010011000100101010100100
11011101000000000010100100000000001100000000001110000011011100100010001000010101000011000100100000010
00000010000000011100001010000000011100000011100010000100011010000000000001001011110010000010010001110
00000101000100000010000010101001110000001001100110110001000011010001110010010100000000000000000010010
01000000101010101000001100101000010001010000100001100100111011100011101111010110010100110000000101000
00100000000001000001000000100001100010000110010100001010001000001100011011100000010000000100001000010
00010001010000111000000011110000000010101000001000000000110001011001000000000001001000000011000010010
11010000000111000001001111000100001000100000100100100001000010001111100010000001001001100110110010010
00000000100001100110000100000000000110010001110010000011100010001100011101000011000010001010010000001
10101000000101100100000110110000010101001011010000100110100100001001000000010000000010000101100011000
01000011011001010100001011101100100010010000011100000101010100000101110000110101010000010100100010010
00100011100000000000010001010011001100100000010001010000101010001000001010000000010000100011111001000
11101101000100101001100100100110011010010000000000010101001001010100000101101101100101101000001000000
01001010000001000001010001000100011011000000010010001000001000101010001000100001011111100010100101010
00001000000101001011010001000000011011100000001000010000010110010010000010000000101000001001000100000
00110010101001001010110000100001010011001101001000110101010010001000011101110000000110010010010001100
10001001010010000110001011001100001001000010100000000101100000001000001000000000000100101010001000000
01000000010000000010101100000111100001001000011000000001000101000010100000000000100000000100010101000
