00000101111011100001000000100000000110100000001100100100100011010100010111010000000011011000000100110
10001000100010001110001010000011000001101011010101001000000100001000000100000000010000100010000000000
10000000001001000000110010001000010000001010000000000110101011000000000000000011000001001110000001100
11100110110000000010000000110000000010010110000000010101011100000100100010110110011010010000000010100
01001001111010111010100000000100000001010000100010101000001000010010011101110110000110000100001010001
10100001110010100001000010001000110010011000100100000010000100001000010110000000000011001110001011000
00010010100000001011000000000001010011000010100010001100000101000000000000010011100111100100100000000
11011011000001000000010001000000011111100000011110001101000000001000000001100001100100000000101010001
10100000000000000010000010000000110010001010110000101110001100000100001000000000110000011010100000100
00001101011000101001000101110100001110001000000000101100001010101110010000100110000101010000000110110
00001010100000001000100010000101100000011000000110011010000100001000000000000010100010001001100000001
01100011101000011101000110010000010000000101001000101010100000101000100010001001000001000000110011100
11000000001001011000000111100000000010010000010000000010001001010011000011001100000001101101000000110
10100010000100010011100000011101000100100101001000001001001010001101111101000000000000010100100100000
00000000010011010000010100000100011100001111001011111000000000010000101000000100000000001000100000001
01001000001010000000011001010110000010001110000111010000111010010101100010000001110000010001001001000
10100001101111110101000001100100011000000110000101100000101011100010000100010011011010000010011000010
10100011000101000000101010100000000011000001111001001001100011010000101110010111011101011000111110000
10000010001000000000000100011000001011000000100010100000100000000000000010100110011010001010100001000
00100001001000000011001100011000000001011000000000011000010000001010100010001010001100101000000010000
00000110001000111010001001000110100100001010000001010100000000000000000010000000000100010001010000000
00010001101010000011001010001000001111100100100100101011000111001011000001000100110110000000010001000
00001000001110100010010000011001001000000100000001000011101000000110010000001011011001100111000110110
10110101011100010000001000001100100100000000100000110010000001010011000000000100001011101000110001100
00000000000000001110010110110001000001001001011000100000000011001000011000000110010010011011110110110
10000010001010110101001000001000000110001000001001000011000001000000000000100000010100110101100000101
10001000010000100000010000100111010000000100010000100101000010001101010000000000010110000110000000001
00000100001010110011000101001011011000000100111101000101000000000000000101000110010011000001101000000
01011010011010000010101001110001000110010100000110001110100110100101001100001000110000000000010000010
01000100010001100010000000011000100010010001010100000100010000010011100000000101101011001000110111100
10000000011100010000100001110010000000000000100100111010000001000000100000000001101000010010100000001
11001110100100100011100110000000100000000000000010000010010000001010100110000000111101011000000011000
00110110010011011101101000001010010011011110010101101100001111001010000010010010010001011010001000100
00111001001011110001010010010010010100000000000001011001000100011000010010101000100010010001000100110
00000011110000011000010100001000000111101001110000100000000101000001000000011101010000000000000101010
01000010011010000001010011000001000110001110000100010001010110001000100000000010000011100010110010100
00000111010000000001110001000101000000000010010000000000010000110010000000110001000110100001010100000
00100001000000001010000001001000000010001001100000001100001010100110010001000010100000000100000110010
01001001000000000100010000100001001100000100110001000000001000001000010001111100001001000100100000001
10010010001001100001100011000110010110010001101001010110110000001010000100100101011100001000100000001
11001110011000101001101100100000000010000101001001001110010000010100010101000100100011000000011000001
01010001100010101100010100111101001000000001010000101000101100000100100000001010100010100000011001000
00001000010100001001010010000000000001101100010000110001101011001001110011000000001010001000100010010
10010000001000001000001000000010000001001000100000100010110100011000000000100110000001010000111010010
10001010010100001011001010000000000100010000000010101010100100000000010010011110000001100001000000010
00010001010000011001000100000000000001000110000000011000000010000100010101010001000010110101010001001
10011000000010000010100100000110000011000010001100000010010111101101100110000110000011000000011000100
01001101100000001101001110010100000110100111011110110001101000110101001010001010000110101010000100000
01101100000001010010111100000010101100010011000100001001101111000101000000011010101001010000000001000
10000000011000000000000101010100000000001000001100010001000001100100100110010001101000110001010011000
10100011010101001010010010100111000000100010100100010000001010000100000101100000101000111011011010000
10000000010000000000110100100110001000111000011101000000010000000010001010100010000000000001000100111
00100100000010000110001000000000001000010110000000001110110000000010110101100001000101010010010000010
00100001100000111100001010001110000000001001000000000000000001110011000010011001100100000011000000101
00001111101001000100000010100000110111000110001100111000110000110100000101001001000101100000000100000
00110001000011011000100000010100000000010110000001000100010010000000100010010000000000101000000001000
01010010011010010000000000000001000010000000100010001001011000001000000001010010011101000100101101101
00111000010110010000010101011101000000001101101000000001101101010000110000000001000000010001011101110
01000000100001000010100000011010001000000000010000000000101010000110001110011000000000111000000000000
00001100011001100010101100011000101000000000101110000000010000100000001010100000011001010110100011010
00000010100000010111001001001000000010100111000000000011100000011110011001011010100000100001000000000
10011011100010010011000000001011000100000000100000010101001000100110010001000010001011001000000011101
10000100000001010000000100010111000000010010110000000000010001000000010100000100110111000011001000111
10000110000000010101000010000100010010010010110010001100000101000000001011000000010010011100100000001
11000000110000110110000000100001000000000101011000001100110010000001001100010000001000100000001010000
11000000000010000001100000010101000010000000001011110010001010000000100010000100000101100001101100000
00100001000101100110100000001111010000001100001001000001001010001010110101000000000001110010000101000
10101011000100100010100010000000110100000000011000100001010010101000000011000000110001001110001000010
00010100000000000100000000100010000100010000000000000010000101011101001000100000000101000010010010000
00000000010000001000001100010000011010110001000010011101010000000100000010010000000011010110010000100
01000111001111001011000001001110010010101000110000101010011100000110011011000010101100001001000010001
10000000000010100010001000100000100010010000100001101000000010000000011010001100000000010001010111100
01001000100000101100000010100101000100001000111000000100010110000010001011010100010101100010101000111
10010110100010100001000010100001010001101000011000000110000001001000000000010100011000001110010001110
10001100100011100000010001011001010100010101011001001100001001110100110001000000000111010000000010000
00100010001010000000010010011100000110010000000100011010000011101011000011001011100011000010000000011
00000001000001010001001100100000011001000000000011010000000000001000010001001000010000000000000011110
01000010100001001010011001000000110000001001001000100010001000010100001011011101000101100000000101010
11100000001000000010011001110111001000010010100000000010101100100011000100010010000001000100000000000
10010000000001110000001000000000100101000001000100010011000110010011000110000010000000000100000000011
10100010000100100100001110000100000100000000100010100100001010000100100011100000010001000000001010101
01110000000001010000100011011000100101000000000000001100000100011001000001101100001000001010100100001
01100110000100100010001010010001111000101000100000101010000000110010001000110001100011010000100000001
00000100001001001010000010011000000011000000100001000010000000010010000000110001000100100001000001100
00000101000100000110000011101010001000000000011001100000001010100000001000100010100100001011101000001
00100010100000100000001000010000010001100110000100010000000001110011010100010000100101001111110000101
00010001111011000000000001100000000001001001000000000000001100110000010000000001100000010001000001010
00001000001010000100100000010110000000000000011010001011000001000001010000000001001100010000100000110
01001001010010001010010011000100000010011000111100001001100010001100001010010100011110000010000110010
01010110000000011000001011000000000011000000000001111110100010100000000000100000010000010110100000000
10000100100000000010000001000101010101001001010010001100000101001000010000111000000100010000000000000
10000101101101000000100010001111001111000100101000000010000110101010010100100000011000000000000000000
00000100010110000110000000100100010000100000001110110001001000110100010010010001001001011100000000010
01000100101100100000011000100101101100000010001110000000000101000011011011000011001100110101000001110
10011100010100000100001001000001110000010000100010001000100001001010010000010000000001101000001000100
10011000000000000000110101010101110000010000100100010000010100010011000000000000011011100000010000001
01110001000010000000101001000100100010111001101001000110010000001000010010001100101101101100001001000
01001000010000000001010110000010010011101010000001000001000000000010000000100010101110100001001110000
01000111001010010100010001100100010101110101000101000011000100000101000110000110001101011001001001001
01110010001010001000000000000000010000001100000011001001000000000101000000000000011100001011010010000
10000001000111001000010001010000000010001010101000100001000000000101100010000001010110000010010000110
