00011001101000100010100000110111000010000101000100000010000100000001101000010110000100100101000011110
10000000000010010010110011000010001010000000001001010000100000010001010101011100110010011001010100000
10111100110010010010000010010110011001000000110001000010000000011101010101000110010111101000101100100
00111000000000000000100100111001011001000000000000100000100000110110011100010000100100001000110100011
01010100100010000010000000111001001010100000000001001000010001000000000000001100010000000011100000000
00101100101000110101111000000000000110110000100001010000100000001000000111110000000100010000011001110
11011000100110000101011010110000000101000000101000100000010110111000100000111011100001000001000000000
10010000100110000100001000001011100101010000000111001000110001000111000110111001000010000100001000000
10000000000001010010000010100101110000101000101100101000000000000011111000110001000111010011000000100
10000010010000000110111000010101110100000001000111000000100100101101000100011000011001100000100011000
01011101000010001101100000010010000010001101000100001111111001111110000010000100101000001101000100000
01000000110010110000000100000101010000000000000000100100000010100100001010001000001000010101001011000
00110100001000000000001101000101001001001001000100010000100011100010100110000000000000000010001000000
00010011010000100000100000101000101011000000001100000010000000000000000001101000000010110100000011000
10000000101011000010001001000000000111110010011001001100001000100011001011000001010000000001100001100
10110000000100100110111000001101010100110000000000110010100010110100101001000001000010100011010000010
11000001000000001000001001011000110100101110000000100001110111001000010100010100010000001101000000100
01101001110000010010000101000010100101000100000000000000000010010100100101100111000000100100000010001
00000001000000110111010010100011010001000000000011000010000010000100001000111101000000000100011100100
01110000100000000001111010100001101110101100001000000010111000001110000000100000011100010010010000000
00000011010000010110000011000000000010010001011111001100101100000010000001111100100001110000000000000
00000011111110100000000000000001010010110100101000110110010010111001000100010001000000000101110000001
10000001010001001011011000011000010000000010100000001000011001000010111000000010000001000000000000101
00000000110000010000000110101000110000111000000000000000010000001001000000010100110010000000100000010
10000011011000001001000100110000110111000000001100010000000001000010000100011001010010010001100000111
11001011001111010010000101000000000100000001000011010010110010000011110100000000000000000110000010000
11000000111110100010010000000100110001000000000010001101100000001100000010010111000101101010010010000
10001001100000000000001000101000000000011010000100000101100010100101001011000000000000001000000101000
10001010000000101000001001000000011001100100000001010001010000011000100010100000101101110010000000000
01100000000100001100000011110110010011001000010100100010100110100101010000001111001100010000001010010
00010110111000000010011000001001110101001100100100000010110101000110010000001100000001010000011000010
00001000110000100110000111110101110011000010010100000001000000100000000001100000100000000001001011000
01000100101000110010100100000000000110010010000000001010100001010000000010000000000000010011000000010
00000010000000001000100011001010000001000111100000000000000100000000111000010000001001000101100011100
00010010100010100000000110100010101000100001001100000111100010100111000011110000010000011010000000000
01000010100000011001101000010110001110000100000010100000101110101000011100011011010110000010000001000
10100000000000001110101000011100000000011110110001101000110000010001100000100000101100011000100010000
11010000010000100100010001001000000000100100000100000101101000100001000000000011000000101101011001010
10010011011000010001100000000100101010001100010000000001100010001010010010010001000111000000000001010
00100110100100010101100100110000010000000010011111001001100100001101000000000000001000101101000010101
10101101100100000000000000100101000001000100010000010100000110001100000101000001000001000100100011011
10110000001100010010001010011101010000100000000011110000000000010010011000110000000100010000000000101
00010000000100101010011000000000001001011000000011110000100011010100000100011000000100010000000001001
01000001000000000000101001001001000101000010000110000001000000011110100000000011010001000110000001000
01000100101000000000010010100100100000100110011000001001101110000000001000000100001000100100001000101
00000000100101111001010001000011000000000010000000010010000000110110101010000000100000001000000000000
00000000010100100001000001000100010000000000010010011001101011000010000000011000101000000101110011111
00100001110100010000000010010101001000010010010001010001010100110111010101001000000000110000001101110
10110000100111101000100000000010010000000001001001000001010000000000100001001100000110000100001100001
01000111000010110010011010101101010000000000000100000100001010111000100000110000001100000000001001110
00101010100000100100000100010010110001000000001110000000100000110100001111001010011100000110110100110
00100100101010001100110000100010010100000010000001011010100000001000101000100001010110101001010111000
00100010000101000100000001001010011010100010000010011010100001100000010001100101110001100101000100010
00000000101100010001111000010010100100010000000100000010000010000001011100001110000000100000011100010
10001000011100000000100000001000101011100000110000010000010000000001001010000101000010101110100000000
01000000111001000111000010010010001101000011100010001100010000000100000100011010100010110000001010000
01110101001000000111110001101010001111010001101111000000100000001001100000000101000010000100000001000
01001011100001011110000011000001110111111011010001100000001010010001111011001010111100001101100101110
00100101000010011000100000010000000000100101000000100110000010100000001010101011101010000011001100010
01010101001000000110000110000010010000011000001001001100000001001001011100001001101011101100000000000
11000100000000100010010011100001000101011111000001010000100000100001100001000001110001110000000000100
00000100000001101000000010000001100010100000010100011010100000100011100100000101000000100011011001001
00000000001100000100100100011000101010000001000000000000000011000111000010000010010010000100001000000
01000000101001000011000000000100000010110100000001001010000001101100110100001100100110000000111100001
00011110010000000100000001000000010001011011001110000001001000001010001000010000010100010100001011000
10000010100000100000101011000010000100000001001000100000000100000000001000010000100100000000010010011
00000010011110011000100001100101010001010001001000100001101100010000000001000000100001111001000000100
10010000100010101010100100000011000001000101101010101000000000100001000101110111100010110001101001110
00100011001101010000000100010100000001001000000110000001000001001011000010001101001010110000000011000
10010100001001001010010000000000000000001000010001001010000000100000000101100110001110000100100000110
00010001011111101101000000100000001000001010100100011000000000010110000001000111000000001001000000001
00000111000001101010010010011000101110001001000000000101101100010000011000110101100001001100100000001
10111101000100000101100000001101000000110001100110000000100000000010000001100010010100000101001000000
11110011010001111001010000100000000000000000000000101000000001101000101100100001110010000000001000100
01001010110000000100000011100000000111000010000000011000011111110010001010110110110000110100011000000
10010010011010000001111000000000010000101001000000011100010000000000010101111001111000010000000010100
10110000001000001000010010110011001000101100010010011001001100000011000111100000010100011000000101110
01110000101110001001001001010101000010100101010101010000101000101111100000001101000010100100011000011
00000100000011110101000010000101000000011110100100011010000010000010111011010000001100101111110100010
00000000011001001001100010010010001000010000000001000000001100100000110100000001010001010000001100101
00100101011101100100000010110110100110000101000110000010100100100000100100000101011001001100000000101
00001000000010000010000000001000101110011000101000011000010001001001110011000010000000101000000010000
11111010000110111010001010011001010010100011010000000110111101001001011110010000000110010100000000100
00001000010000100100000110000000001000101010000001001011000001010001101000010000100001000010000101100
01000001111000000000000101011000000001001000000010000000100000100000101011001000110001010000000100010
11100000000000000000100010101100101000110100100000000000111000000000000111010000001000001011000001111
01001100000010100001101001000100100000010000101100000000001011000000010001100100010110001000000001000
11000010001100100010111101000100110100010000000001010011010000010000100000000010001101110001000000010
10110100001101000000100001000000010000001100110111000010010001000101101110011000100000010000101000000
00000100000001001101000100000100000001001100101001011000010001010001000100010011010010010001100000000
00010100101011110110001001000000000010000010101000101110000000011100001001100010111010100010100000000
10000000001000000100100000000000000011011001001101010111000011001100101000101100110000011001110001000
00000010010001010011000010111100000010000000000000111100110000000100000001000000101000100000000000001
00000100000100100001000011100000101000000011001001111001011010100110101100000000111000000001100110010
10011010001100000000101000000000000001010110000001000110000000110001001101110000001000100100001000000
10001000110100001010000110110001010000001100000000001110001100001101000011000000100000010000100100010
11000010000011100100000011010000100011110000000000000011010010010010010000100000011010010010000010010
00111000100001000110000000001001010011010101001001100010001000001000011100001001010010010000110011010
00110100000010000011010100110011000110100100000000100011100000101001000000000100001110010111100001000
00001000000011001010001010111000000011110100101001000100001011001000000010000111000110000011010000100
11100000101000100000000000010000000111000000110010011000000001100100011001000000001000110000001000000
