00101000001000000011010000000100010001110000011011010010000101000001000000110110000101000110000001001
00101101110000101100101000000000010000010011101010110111101001000000110011101010110111000010000110100
10000000100010100000110010001100011000000000001110000000010011101000110010000001101000000101000000000
00001000010101100100011000000010110110000000101000001100001101010001000000000000000001100110010000100
10000101101000100000101111111110001000001110001111001010000001010001100001000010100100000010000001100
10000010001000100100100100110001110110101010011000000000001101000001001100111000000101000100000000001
00001010110000010000011010000101101100100010000000000010000110011011001000011000001101010000011010010
01001001011001001100001100100000010100000100000000010010110000100001110000010001000101101001100000001
00000001000000010000010000001011000000000110100001001001000101000000100000000001101001100110000011101
01010001100000000010000000100100101000001111010110010010010010001110000000110000010010000000000100001
01011000000000010011011010111000110001100100010010000100000000110101000001000000001001000000000000001
00000000001000000100010110000010010000000000100000000001100001000100111110001101010100000000110000011
01101100000010100000000001011001111000000000000000100101110110100010111110100010110000100010001010000
00100000000000011100101011001111110100100010100000000010101010011100101001100010001100001101011000000
11000010011101100101000000100010011101000010000010000000100001110000000001000000000100100010110000000
00000000010001110100000000000100010011101011010001000011000000001001000000011111000000000000000000110
11001110000000100011101000001010001000011000000000000000001001001001001001000100000001010011000000000
11100100010000001101100100010100011000100011000100101011000011100001001011010000001101100100100000001
00010000001010010000001001000000101000100001000000000000100001000001001001100011010000000100000101011
00010000010000001000000000001100101100000000001100110000011010000100000100010010000010101011101010000
00011100011001010010010100001011010001010000010001110100000010000010000101011101001000000100100000000
10010001000100111000000000000000000100101001100100000011000000000000000000100111000000101000010000000
00000000000000101000100001010000001010000000000000010010010010000010101000011101000000100011101010001
00001100111100011000001010100010000001011100001000011011101101110000000011001011100010011011001010001
10000101000000000001001001001000001011000000000000000000000001010011100100001000000000010011110000001
00100000001101101010000000100000000000101011101000000001110000010000000000001001101001011101000100001
00100010100010000001100000000100110100001010000001101101001000001000001101100000001100100000000010000
00000100010111000010101100110110110111100001110000011000001100110110001100101000100010000010001000011
00000000101111000011000011000100110010000110001010000000000010000000000010001000100000000001101110000
00011000101100000000000000100000011000110000000000001010111000011000100000100000001000000000111011000
01001100110000100010100001101001010110000000110000111101000000001000010001001100000011010001000100000
01011010000001000010000010000001000000000110000001000001010010011110000000000010100000001000010011001
00000101010000001000000111101100110001110000010000001000101000110010001001100000000000000111010000001
00010001000100001000010000000010000101000000001110000000111001010100001101110011000000100001011011111
11011111001010111001000100110000110000111001001001001110000000001000000100000001011001000001111000001
10101000000000000101000010100000001000001101000010001000000001000110100001001001000010001001011101101
01000111000000100000010000010000100110010000000100001101000000000110101100010100100010000011100011011
10000000000100000000110000000001010010010110100100100000101101000100010001100011110100000010100010110
00101001001111000000110000101100001100000001000100000010010000100100000000110101000000100000000000100
00001000010000100100011010000001000001100000000100001001100010010011100000100010000001011000000010010
00000010100111100101011000000011000111110001100001110011100011011101010001001100001000010001100000000
11010000101010000010001000001010000001001010010000000010110000001000001001001011101100010010010000000
01000100011011010000100001000100000100001011000000110100000000000000101101010011000101000001111011010
01001000100110010000100100000000100000001101000100100110000001000010001110000100011000000000001100110
00000000001101011001000111000000101000010000101000001000001010110000000000100000010110100100100001010
00000100101010110110010010000111001000010011110010000000000000100100110000001001000011101000000010000
00000001000000000000011001100000000010010101010100000110000100010100010110010001111000101000110010111
00100110110011000110000010010100000000011000001010000110001100000010100110000000100001001100001001000
00000010100000100000100000110010110110100011010000001011001010111000010001011000000100000100001111000
01000000101101000000000100001100001011000011000001011001000000000100001000100010000010010000001000001
00010010011101010110000001001000010100100001010000100100100101001000000010001100010100000001000100001
10000000000010101100100000110000000001100000000110110110000111100001100000000011001010010001001010000
01000010001010010000111100010101000100100000100101110101001101101000010000001001010100000010000000100
00101100010000100100100001101010000101100101011100100101011100111000000000110101000000110111101100000
00001000000000100000001101110000000111001000110110001001010010001000000010111000001000000010101011010
10101000000000010001010110100101001001100000101000000001101000000001100000110101000111011001000000101
10000010001000000010110000000000000010000100001010001001000001100000010000000101101010110110000000100
01000010011010001111001000001100011010011000010110001100000001000111001100000010111000110001000100110
10001010001100000000101011010000000001101110011001110010000000010000000010001100000010000000000100101
10000010100101001000001010010001101011010110000000100000000000110000000001000001000000010000000000100
01010101000010010100000000000010101010100100100010111010010001110100000000011000000111000010110000101
10000001100000010010110011000001010000010010100100010001011001011001001000001100110010001000010001101
10000000001100110100000100100101001001011000100110000100100000010110000010010110110110010001000001010
00011100110000100001100000000001101010100010001000010000010001000001011010100101001010011100001000101
00011000100001000110010001110000000010000100011011000011111010001000000000000100011101011000001001000
00000100000001000000000101000000000000001001011011000000000101010010001000000000000010000011111101000
00000010100100101011000110101000001000001001000010011110000001000111011010100000000101101011011010011
00010010001000001001000100010010010000010110010101001000000100011000010110000011001101011100001000010
00001100000100001011101000000100000110101001100000001011100000000001000011000011111000100000000100111
00000100000101000100110010100100000000000001000010101100001001000100010000110100000100000101010100100
10010010000100000001000000001010000110010100001000100001000101000001111100000000010000000001101010001
10001111101100101011010000001000011001001100010000001010000111000111001101010010000001001011000000000
00001010110000000000001000000000001001010010001100010011001000011100011100011001000100010000100100010
01110000100011000001000001001001011001000010000011010110000000100110100000000000000111101000000101101
00100000011100011010101010011100001101111101110001010101100001010101011000100001001000011010011100010
00001010000100010100000010100010000100001001010100000101000110110001101100001010001101000000101000110
00110101010011000100010000100000010100001100100111100010001100000001000000001000000001010010110000111
10100001000000110100100000000000000110100000100010110010001101000000001011010001101100101000101001010
01100010000001000100001000001110010001000000010000000010001010001100000100011000000000010101010110011
00000110000010000000100100011000010100010100110000000100000000011000010001011000011101110100000010000
00000100000011001100001000000100100010100010100000100010100000000011001000100001000010110011100010011
00000010000100101100100100010000100000001010000000110101100010000100100010011010000000000010100001001
01010100001001000110000010100000000011000000101100000001000000000000000010000000110000000000011000001
01100001011100000000010000010010001011001101100010100000000100000010000100010001001101010100111110001
11010011000110010001000001000000100010110000000000010000000001010100000011101000110010111000000000101
01101000000000110000001000001001101101010110000000010000001101000000000110001111001010000001001011000
00001000001000000000100100110000000000000001011100100000000001101000011101000100010010000010001110000
00010010100000111001001001000000010010000110000000001001001111000000000000110000100111000000001000101
01000010001001110011000100001010101000101000101000101001010000011100001010110011101110011011100000010
00100000101010001000000001000000010011100000000000010000000011110100111010001010100010001000010000100
10010111100110000110010011010101010111001001011100000000001000000000100110001110001111000001000110000
00110001000100000000000111000001011001101100110010100000101010001010111001000100010000010011000000100
00001001000100010010110001111011000000100000111111000000000111000100000100000000001001010000001000000
01001011000010101100100000100000010101001001000100100000011000000101100100101000101010011010100110000
00001010100010000000011000000000000000000101100000010000101111000000110100100000000000000010001101001
00101000010010001010010110100001010010000100010000101001010000001011100000000100010110110110001100000
10010001000000010010011100011010100000000110100100110011000001001100001010011010011110100001101000010
00010100100000001100000011001101001100011000101000010000101101001010011110100000110100100000001011100
01110000001010100001110001010110010001010000001000101010100100000100001000101100010100001000001011110
00000100101000100111000000100010001001100010001001000010000000000000001000010100000010010100100100111
01010100010101100110000010010110010010001010100000000010001000011110001000101010100100111001100011010
