00000000110000100001001000000001100110001110100100000010101000100001010000000000101000100000001000010
01011000000111101010110001011101000100010000010011101110100011000000100000110100000001010001000000111
00100101000100010010100010100000100101100000101100100010001000000010100001010010011000000100001111110
00000111000000010011000000010011000011000101101010100110010000000001100000001111000000000110010010001
11100101011010001011111010101011000000100011100100101000010000000001000000000000001000000100100000100
00010000001001001100100000000100100100101001110000010000101100000001000000011100000000101011001010000
00001000000100011010101001010000000010100000000000110000100000000110000010100000010001110001000100010
00000010000000110010011011011000010000000100001000000000100011001001001101011010001101100010010001000
10000000000000010011100010010101001110010000010001100000100011101010100000000000001010000000000000010
01000101010001100100111010000100101000000100100001000010000011000100010000010000001000001000101010100
00100000100100000011010010100000001000100010100000000110100000001001000010000001000000100000010010101
00010000000000000100011101100000010001010000000000000001010100010000101000001000010100000001110000100
00000010101001001001010100110100100000000101100111010101100001010010000010100000000100011000100000000
11001001010010011100100000101010000001100000010010000010010010001000111110101000000111100100000001000
00000000100000100000110010000000011011110100000110001101000111010000001011100000010000100000000000100
00011000001100010110100010100000000111100010001101000110011101000000000000001110000001000000000100110
00000001000111101000100010100000000101001000100100101000100001000001000000000001100110011000010000010
10110000011011011000000100110000000011000001010110010000110001110010100010110000010000011001001000000
00100011000010010000101001100011000000101110000000000000011100001100000100100000110011100100011000100
00100001000000111010111011100110100000010100110100010000100010100001011001011000010100000100000000000
00000100000010101000000100001000000000000000110111110100000001100010000100001000001000000011001010000
00100000000000010011110010000100101100100011100011011101001110100100001000101000100001000000000011010
10100000100000101001001000110011100011010000111000100001111100010000010010100000000100001100000001000
10000001010001000010001001100100011000100010011000000000000001100000010000000000001001000001100010000
00000110100000000000000101100011000100111010110000000111011011001101100000000000001100100010111111000
00000001000000010100000000010011000100000101110001010010100111001010011001110100100001010000000001010
00010000100100010000111010010000101011001000000110100001010000011000100010100000000010001010101000100
10010011001011001110000110001010000100000000011000100100011110000000001000110010010000100110100100000
11010101000000001000000010000100000100000011000001010000000100000000000001000001000100000010100000000
10000000000010100100101101110100101011001100001000001001000000101010100000100100000101001011100000001
10010000001010001000110000011001111000001101010100110000000100010001001000001001101000011001010100101
01100000010000101011000001011100100011011000010010101001100011010010000001001001011011001000000010110
01010110000100101001010000000000010001000110000010101110110000110000000000000000000010100010100001010
10011001111100000000111001100000001110100010100000000000000101000000000110100101000000001001010000011
11100110000101100111000010100000000100000001000001000010011101100000111100000100101010000001000010001
01001001000010100111100100000001000011011110110000010010011001000101000011011010001001000101010110100
01000000100100100000000010001000111101100010011100011000000000010001110000000000100010001100100000111
10010010100000000010010000000000100000100110011101000000010110011001000001000011111000001001001110110
00100000000000010110000010011011000100110111000010100010010000000011010000100001001000100000010000100
00110101001101011100010100101110010011000001101010010011101000101001101010000010110100000000001101000
10011110100101000001100000101111001000000100000000001010010000101100010000000001100000001001000010000
01011010010011001100000100000110010100010000010011001000010001010100001100110110111100100000000011000
10110000000001000000000000001010010111000100000011001100011011100100100100111010100010111010010100111
10010010110100100001010011011001001110101110011000001000110000001000110000001100100000000001101000010
00000000101100001011010010010010000011101001010110100110001011000000010000001001001000000100101101000
10111001000100110000010010000010001010100110100110100111000000000010000000010101101000010001100011100
00000000000000001000101001001001001101101011000000100010101000001100100100001000001000000101010010101
00000101010000000011001100010001000000000010100100000111000010011000100010001000111010000000000000100
01100001000100001000101010001100001000010000001010000010000100000010001100010000000000010101110000010
10011000011100110100001010100100000000100101000000000000000000100000011011000011010101000000000011000
10000100000000010011000110000100000010010010000000000100000001010100000010001001010000000001000110101
00110000001000011110110000100100000010011000100001000101001000010001001110100111000000001000001110010
00101001000011000000010100001100010111000000001100011000110101000101000011000100010100001111000101000
00000101000110010010000110101001000001110110111001101000001101010000000110010110000001000011000001000
00000000100010000000000000000101010000100001010101101011000100000001110010000100000010000000000001110
00011010000000101000000000010000011000100100101000001000100011000001000000010100101101100000000001000
00001000000101001000000110100000000100000011010001000100100101000010100010000000010010001100001101001
10010110101101010101010011010100001010001000000101000000000111000000100011001010011110010001000000001
00001001110101001011000000000001100011001101100010001000001110001100000000010011000000011000000100010
00010000000010000110100100101101101001101000000100010110000001010001011000000100100000001111000101010
01010000011001100001001111101000011010110110010010000000000000000010000111001010111100101010000100101
10101010000001000000000100000001000000101100100100000010010000000000000010001100100000101000000100010
10010000001000100111110000001011100000000000100011101100100101000010010110010001000100010000010010111
00000000010010100000001010000001101000100010001000100011001000010000000001100000010010110100000000000
10101010010111001001010011000100100000111010001001010011010000000110000010000101011000000100010111000
10100000011011100110001011000001001011100110100011110101010001000010111100011001111000001000100111001
00111000000011100000000110100010011010000010000001100100001001110000010100000101010000000110000010101
00000001001001101100000100100001100000100110010011110001001001100001010000111110010010010101101110110
11010110011100010010000010000001001110000000100100010001000000101001000010001000010100011001001000000
01100000000001010000010100010100010000101111010110100000100010000111000010000100000010000010000001001
00000001110110000010100000000001001100110110001010110000100100000000000010001001010000100001100010000
00000000101000000010001000111000000000101010001100101101000100000001100010000101001000000010100100010
10101001001101010111100000000000001010010100011001000000001111110000010001000110001010000100000000001
01000000011100000001001001000000010000001000001101100010000001100010011101000000011011100000111110000
00001000000100110100100100101001001001000000010010010001010001100000001000010001000101011000000100100
10100000000001000000001000001000000000010100100000010101011001000010000010000100000000000100110001000
00100000000000000010001000000010000000010010100010010000000000000001000000010000101000000110000101010
11100000010000000111000100100010010100001000000001100001001101010001010100000010010000010000000100101
11101001101100100000100001000000100010000110001010111000101100010000110010000001001010010010100100010
00001011001000100000011001101010011000000100011100000100000100000001110000010101100101000000001010101
00000000100000100001100010010000010000000100001100001001101000000000110010000110000100000000110001100
01100101100000011000000100010001101000010010110000000010000010000001100000011010100010000000000101010
10001100010000010100000110110011100000001001011100000100000111011011000000001100100010000010011000001
00000000110001011001000000100100101000110000000000000001000000000000000011010000000000010000110010100
10000001000001100000000110101000100000100010100010100010000010010111110000000101001010001000000000011
00000000000000001001100011000001000010000000001000000001000101011010010000000000000000000000000011110
10011000000100001100001101011011001111000010000000000010011010011100101000000000001000000111000000010
10000001110101100100011000001110011001100100000010000000111010100000000110000100011101010001010000100
01001100100000001000100000000001000000000100100011000000011101000101001101100110011100100010100010100
01000001000001000010011001000111010011101010001010000000000010000000001010101100100000000011100100000
01010110101001000011010000001100001010001010000010001101001101000110100001001110010101110001010101001
11111001010000000001101101010010110101100000001000100010101101000000001010000000000110010000011001110
00001000000000010100101010101100000101110000100001000000001101000011101000000100001100010000000000010
10011010011010111101010000001111011010000100011000000010000100000100000001100000010011110000100001010
00011101110101011000100001010010011000001001010001111011110001000001001101000001010010101110010100001
00110011111000001011100000110010100011100000001111101011100101000111000001101100000001010011010100001
10010101100110010010011001011001101000011011000001110000000000001100100010101000000100010010100000010
00110010011110000010100000000100001001000000001000110100000000010100100001000001010000000110000001000
00001000010011000001100010011000100100001100000110000100000001000000000010001000100000000000011101110
01100010000010110100110000001101000011000100100000010000000011000100000000000000000010110010000000000
00001100000000000000000010000001100001011100111011001001010001100100011000010000100100000001010000000
