01011000100001110000000001110000000011110000000100010110010011001000100100010000100000110101000010101
00010101001000000000010000010100100110111111100000010001010000010101000100001001000110000000011011000
10000000001001000001010001000100010000000000100010110000010100000000010011011100000011010011001000000
10000010000110000000000101001010000100001011010010001000010100000010000011000010011010001011010000000
00010101000101001001010101000000010110001100000100111010000100100110000000000010001000011001100100001
00000000110010010000000000111000101000001001100100101000001000000001000001010011100000000110010000110
00000100000001001110000001110100011001000000001000000001000000000001000011110000100001101000010000000
10100001001010000010011001010100000011001000100000000000000110000000001101100000001010000100101001010
11000100110100011100010000101010001000000111000000010100100010000001001010000000011000100001000011111
10111000101000010010000011000001001010010110101110000000111010111011111000101010001000000010001000110
10100001001001000100000010110000000010100000100110001000001001000110001100000111000000000000001100001
10010000000100110101101000001000010000000100010000101001000010100001011000010100110001110001101011010
00100100000100100000010100010010000001000110101000101000000011110000001100011000000001000001000000000
10100000110001001000001100000001000001010011000010000110111000010000001000001101100000110001100011010
00101001000001100010000000110001000001111010001010000010000110000001001011001011000000011010010100011
00100000010001110100010001110010000000000000001001101100101001010100001101001000000001011000000011010
00101111100000000000001010000100000000101000100000000100010011010011100000000110100010100000100010000
00000100001000110000011111100010100111100011100001100000100100111111010010000100100001100000001000100
01000111000000000101100000010110010110110101010111000000101000000000010011000100001000010101001010100
01010011010110000000101001000001010101000100100000100110000001000100001001010000010000000100010010001
01000101110100010000101000100000111000110000000010010000100010100100011100010100100000000100010110110
00011000000000011100000101001000010010100101101110101100110010000000001000001000000000010000001000001
00000110001100000100101000011101010110011000000011101001001000000000001010010100001011000011110100010
00010100011110011001001100000010010001111000110101110000100000001000010010011101010100000011100000100
00000000000000100010010010001000011000100010000000001101000011111110010000010011000101000100000001000
00100000000010011000000000001101100010000101000000100000000001000100011001101010000110100001001001011
00010110100000011000010110011001010111011101100001000000110000110000011000010001010001100000100010010
01000100000001110000001100100010100000101110001100000011000000011000000011000001100000100011001000000
00001100100000001001100110000001000000111101001100100100011100101101000110000001001000001010100011110
00001000001000001000110011110100100000000000000100101000001010011000000010000000000000010100000110000
00101000010011100110100100001001000001000001000000001010100100110011000001000111011000000100000100100
00011000000111100111001110000010110010010100001000000100110000010110010010011000000010100010001101001
00001001101000111000000010010011001000011001011001110001100001100100100000000011000010010000001001100
00001000110000001010100000011000000000011000011001011000110010110100000000101010000101010000000000000
10111000011000000000000011100000010001011001001001010010000000101001111100000000000010011000000101100
01000001111001011000001000000000011001111100100011000010011010011010001011011001011010010110000010000
01000101100000010100000100001010001011111000100001100000100010000000010000010100000100000110001000001
00100011000100000110000000001110111100011000001000010000000001111011001001000101010100000000100001000
00110000100110010010001000001100110101100110001001001000000000000000000000010110001000010111000100001
00100000001000100101000000001000111100100000000000001000000000000000000000110000000000000100111000000
00011010001101000110000000010000010000000010101001000111011001101000000000001101110011000000000001000
11001000000100011010000001010000000011001011001000000001110000011000000110110000001010010001010101000
00010010001000000000100000000000101000000011100010011000111001000000000000000011000100000100101010100
00001100010011001000011000001100011000000101000001000000000000000010011001101000011000110100000000000
00100000111110110000010010100011000011010011001100101110101001010000101100000000000010000010010001100
00000000101100100000100000000000010001100000010000000000001100000001000000100010000010001111000100011
00000000001000101000000001000100000101010000110001000001111001011010011011110101100100100101000000001
00100010000001110000100001100000011101100010000000000010110010000100000010001000100001010010100001001
01101000000010001100001100100000100001100010100001011001000000000001000100000001000010101001000101100
01110000010000100100100000011010000000000100100001010100001001001101010010000000010000101101000100010
10101000000110100000010100101000000000000010100000000000011000011011010100000100000110000000000111000
00100000010000000010100000001000000001000001100001100000010000000000000100001011100010010010100010000
01001110001011000000110011001000100010000001000011010111110010101001100110101000100101101010100010100
00000110000001010000000101000000100101000100010100000000001100110000001001010000011001000010010000011
00000100010000000100100101100001000011000000001000100000001111101000000100000101010001101000010001100
00000001001000000001000100010010010000000100010101100000001001000100010010000100110001101111000010101
01000000010100010000101000100000010000100110101000000001100110000000100000001000111100000000110010001
10010000000011111010100110010011001101010010011000000111100010001111101001000001000110001000010010001
00000110001000011010000011101101001000000100000000000100010010011100100000100100011011000001001100000
10111000110010010100111010000000000111001001011001000100001100000010000011100000000000011010011011010
00001000001000001000100000001000001010010010101001101000001000010100010000001111010101000000001110000
10001000000001100001010100001100000000000100011000000010100010000010011100000000010000001001010010011
00000001000100001011100100001000010010001100100000001010010011010101000000011100010000010001000001100
11000001000011100101011000100101010100001111110110010000000010010001000111001101010011000000000000011
10101010100000101010001000000000011000001010000101010101100010001000011000100101110000000000010000000
10000011111110001011001100001101100000010101101010000001000000100100010000000000010010010000001100100
00101100010101001000010110000101100100001000000010000100111101100101000100100001100100001000010000100
11000100010100110001010100011000000000000010010011100000000000000010001001010000100101101001001010100
01000000001001001100000001000010011000000100101100110100000011000010100000000111000001110101101000101
00000010100110001101010000100100001000110000000001001000001011011011010100000001101010100100110001001
00000000000001100110000000100000001001100001011101100010010000000000000101100101000010110010110010001
10000010000001001111001001101010001100010110000100000000000000100010000000010010111001101000110001110
00010010011000100000001001001000110001000001001001000011000001000000001000000110000000000100100110100
00000100010111100000100111001100010101000111011100100000010011001100011000000000001100010000000000001
00000101011100100001000000010010010001110010011000001100000111010010010111100001010100001101110111010
00001000010111000000000001100100110101000000101000010000000001010100100000111010101000101101011101100
01001010000001100000100000110001000001000010001001000010011000111100010011011101001110001010010000000
01000000010000000000000010111000010110000000000001000100110100000011000000011001000001100000101000110
10001000010000010000001110010001001000010100100010010011100001110001011000000001010100010100000000000
01000010000011000101010101001110101100010110000000001101011000000100010101011000000100000100000000001
10101000000001101010100100000001000000000011100000010011000001000001000100001010000000001000000100001
00000001101000010011100110110000000001000011000000010001000000010001100110000100001010100000001000000
01100010001110000011101000001100000000001100000101101011000010010100100000110000010010110000000000100
00000001011000100100000000001110000000001011100000001000100001010101110101100000011001000001010100001
00101101001000000010000000101001010100010011100010100011100010011000001001010000000010001000101010000
01001100000000000100000001101010011111001100111011000000010100011100000001000000000011000000000100100
00001000100100000000001000011000111000101101110100101001000000100001000110110001011000100101001000101
10010010010100001000100001000011111010010000101001011000000011000110001010100101110000011000001010101
00000010110101010001110000000001000000010011101000100000000000010010000101001000110000010001000000100
10100011010011101001000001101000001000101000101000101110001101001110000110000011000000100000010010011
00101011010000011010100101100110101000000101100100010000000001000000000000110011000110010000000011000
00011001101011000000000000011100000000110101110001000000001010010011000010000100010001000000101001111
00110010011001011010010000011010010010110110000010001110110001000100000000010000100011000001011111101
00110000111001011000111110011001100100110100000001111000000000000000000011010100001111010000001000110
00001010000101001000000010000110010010000000100000011110000001000000110000100000001000000000000001111
00000011000000010011000001000100000000100000000001000010000100100000001000001000100000000000010101110
10101000010001010100011110000000001110101011001001101001110000001000110000000010100100001010010000000
01110110001000010001000100000101000000001001011110100000000100001001000100000001011100110100000000010
10000101000000100010000100000000000101010000000011100000001000010000011001000000001110110000010100010
01011000100001100000010010000010000100100000001000100010001010000110010010101001110000001000101011001
01001001101011010010001010000001101100010000010000000000000000001010000100000110010000010001111101000
