00010010000010000000010001111000000010110001010000100000001010010110000000010001001110000101001010010
10000000101000001001011011000000100100010011000010011100000000000011100000101010110000001000110010010
10011000011010000110000101000111100100000100001001010100011100000010001011100010000011100000110010001
01001100110000011100110000100010101011100000000001000000000000111001001000000100011000001011000111100
10000100010101001000111000010100101001000110001000010001000010011000001001100000100001110010000110011
00001110010100100010101001110000010000001001001000100000000000010001010010010110110001010111101000111
00001000000110011101101000101100000101001011010000011000100110000000000000000010010010001001100000000
00100000010010010000001101101000111100011000100100000000110000000100001101000001011000000011000000100
00010000100000000000101100100000010000100101000000010000001000000011101000000000001000000000001110100
10101100000000001000000000000100000100110010001000011010100000100000100111001000100000001100010110100
00000011000010000110010000000000000110011000100101000001000100000110000110000110011011010010000000101
00100000000001100001000001010010100001000100001010110000010010000101000000110000111110110000001110000
00010001000010100101100101001000110000001100100010000100001000010010000110000100001000110100001011000
01101000000100000100010000010010000011000110100001000000000101000000010000100111010001010000000100110
00000101010010000100100010110100010101001001000011010000100111000000000011000101101010000010010110010
10000100001000000000000011001001000100010010100001010010001011010010110100000101000000000001100000100
00111000000100010000000000010100000000110000010010100000000100100010010001001101000100001000100100000
10000101000000000000000001001110000100000000110100000100111101010110010010001000000000001101000000101
10010100100000010010011000001100100100000000000000000010110011000100100100000000101000101001010100001
01010100010100110110001000010010100010001011110010001100001011110010100000011011000000100001001000101
10001010000000010100010100001000000110000100010010000000010001000000000011100000110100101000110100000
00000000010001001001010000101001001010000101000010011000001000010010001000111000010101100000010000011
00000001010011000010100000000010000011000011001111000000011000110001010100010100100001000010001000001
10001101000001000000000001000001100000000000110010110000010010100000100100001100001001001001001000100
11100000001000000000110001010000101100101101001000000000001110000010000000000001000001000001000000110
10001001110000000100000010000110000000000000000000001001010111000000000000100011000000000010100101000
10100011000110100111000101110010111000010010001000100001000010101111010110100000010010000010000000000
00000101001110010110100000000101100000100100000110110100001000110000111011000111001001100110000010010
00001001100000010000000100000010011100101000000101010110000000001100001101000000101000111000010000000
10000000000011000001111000000000000100001000001100000100010110000100000000111100001001001100001011010
00000100010100010000000010110000010010010001010100101000010001100010100000110111110010010010000100010
00000100001000000100010001101000100000000010011000011100000000000010000100110010110000110000000110100
00100000000000100110000100001100101001100101100010101100101111000000010000001100010001000101000011000
00000101000100000000110001000000000000001110000010010000100011000000100000000010010100001000000001000
00001010001100000011100001000110110000011100001000100100000100010010000001010001000000011010000010000
00000101000010010011000100110001100000010000000010000000000110000010100101000001011011110000001100000
01001101000000100000101000010001010001010100100101000011100000010010000101010000000000000000001000110
00010010000110100001001000110000001001110100000000010100110100000010000001110100010011001001110110010
01010000001100000000001000010001001000011000101100101000001000010110100100000001000100001000100001011
11001001011110100000010101100001000100000010000000100110000001000010000010000101111000100001000001000
00101110001010010001101110001000111100000101011100000011010111001000111001101010010010100000001000000
00100001100100010110100111101100110000000101010000000101010000000100001010001010001011000000000001101
01010000000000010100000001001100000011001000100000101101110001000101000000111001000010000010011011000
00001110101011101000101100100000110001000011100110001000101000100011000101110000000110010110100011000
10101010100011010000001000000100010000001000100000001000110000001000101100000101011100000100010110011
01001100010001000010011010000000100010010001010011000100101000000110010000100110000000001000110000111
00011001100101010000000100101000001010010000000001001110010110011101000000000001100000100000000011100
00000001100000001100000000000100010000100010000000100001001000000000110000000000110110000100000000101
00101001001001100010100000000000000000110100101000000101010000000001000001001100001110010010001110000
00111010000011000000010000000010101000000101011000011000000101000000000011000000010100010101001100000
01100000000000010000011000000110000001000010000000000101010100110010000001000010001110100110100100011
10100100110100000100000111100011001110100000101010000011100001100000000000001010000000011100000010011
00111110001100101000110101101000000000000000100111000010000000111010001000011000110010101001001000100
00010000100000010001001001110011001000110110100000010000001000001100000001010100001000100001010000100
10110010000101010100000000011100000101010100100000001011111000001100101000010001000000010011111001100
00101010000111001000010001000000010001001111000000000001000000010010001000001011110111110011000001111
00010000000000100110100100011011000110000001000000001000100010000000000000100010110111000001000000000
10101100100001000000011111010001000000000101000110000000001000111000000100100100010010000101001000110
11001011001000000000000000110001100011001000010000100101100001011000000100000000000000000100000011110
10000000000100111000100011010110110000000000001000010100101110000100000011101110111001011011111100000
00100001001010000101001001001000000101000000000101000000001100001000000100001010011000000000000001110
00000100001000000001011000010101100010011001001001110000000000000001000010101000010111000110000000001
01100010000011011101000011100000001010100000000001000000101100001011000010001100011101000000100101010
00000000100000000000000101000000010101000010010101000000000001000010000010110001011010000000100001000
10010110001000010000000100010000000000000000000010000001000101010001011100110000010000010100000000010
11110110010000001110010000000000100100000001000010100000110000001000100010000000010001011100100010000
01111110000010001010000010110000000000010010000000100000100000100011000011010101101000001010000100010
00010100101100110101110000011011110100001111100100001001110010011000010011111001011000000011000010101
01100001101100011000010000001010100000010000010000100100100010000001101000110100111010000000101001000
01010000001000100000000101101000011000101001011110110000001000110100001000000101000001001000110010001
00011100010000000000001000101000001000000010000000010010001000001100000001011100110000110001100000000
00000011010000001000100100000100010100100010010010000010001100010100001010000001001001000100000000000
00000010100010001110011000110001100110001101010010011100010000000000011001100010001001110000000011001
00000001111011011000010000000010001001001000011001000010101000101000010101000000101000100011000000000
00110000001111001100100100000100000010010101000100001010001100000100101000100000100010000001010011001
10101010110100010100010000010111101110001110110110110000101000000001011010000001100000001010001001010
10100101111110000100101000000000000010110110010000110110100101100100000101001000000000101000100000000
00001010011000001110011100100100000100110000000000110000010100100000010010010001000010010100000000000
11010000001000010101001110000010000010010001010001011000100000000000101010000000000101101001011110000
00001000010000100000010001100100100000010010001001000000001000110001000101000100001000001100000001100
11000001110011101000000010000000000000100000000000000110000011010001101010100001001100010001011101000
00000001011101110000100110000001000000001011001100000011001001000100000100000010001000110000100001000
01110000100010101011000110110100010010100000010100000000100000010100000100111001000110001000000010000
00000000001101010001011000000100010000010001000000100011100100000000101000000001101000000000010010010
00000001101001010111110000010000101000000010000100001000011000000010001011011010111011000100100011000
00000101001001010000000100100000110010010000100000000010000100100000010111100000000001010010011010100
10001010100000011010000010011000000000010110000100010000000000001001110001100000001011000010001000000
10101001000011010101001000100100110010001100111001001000000100110100000000000110110011111000010001010
10100000100000100110001000000100010010010101111000000000100001110000001000100000001010010100001001000
10000000000001000001000000100001010001000100010000000000101011000001000001001000010000001100000010100
10010000000110010100000100011010001010101001000100110001101000001100101000111111111000000010010000000
01000000000000000110000100000001000011000100000101100000000100000001000111011001111011100001000010001
11000001100000110000100010000000110110001000101000000000000000011001010000010001000110000100110001000
11001011000100100111000100001100000000010000000111110010111101101010100000000100010001010001000101111
01000000100100001000010100000000001100001010101000010100001010110101101000001101010110010000101101000
00000001000010100001110001100000000001011111100110010011000010011000000010000001010100100000000001010
10010101001000000000010000100000001000110010100011000000000000000000101001000001001010000101000000000
00110000000110000111110000000000000000000010001100000000101101010110000000010100000000100010100010000
00001001001100000000101101110001010000000000000000000000101111010011000100110000000101110110000000000
00001101000010010000010000000000000100010011000000000000000001000110111101110001010100000100010100000
11001100100000110010100001000010111000100000000010010100011000000100010100001111100001001100000011100
