00111000010100000000100000010000000011000000110110000001110101000010000000001100100001000010100000000
00010000010000100000011000000010001111000000001010011000000110000100000000010101000010000100000001011
01000001000100101100011001110100110100000001001000000000100010000000000100001100010110000010000000111
01001111110101011001111010100010101001101001001100100100101010100010001001000110001100010001000110000
10000010000111000011000001010001100000101000100000101001011000110000111100000000010011100000000100101
10110100000101001000000000010010001100000010010001000100000001001110000010010000110001010001101110000
00011000010000000000000101000010000110101001100001101010000101100000110100010000111100001100000111010
01100010110000011000000001000100000000010000000010000010000000000100001000011000000000000001000100000
00010000000001000000110000010000110000000000000101000000100000000110110000000101000110000010000110000
10010000110100101000100011100000000010000000000000011001000101000001000110010010010001000011000001110
00000001001001110100010000010110110010010000011100001000010000000001100000000001100100001010001111010
00000000001001000000010000010100010000101110100010100001100000001110101000100000010111001000100010001
10001000100110001110010101000010010100010100000010011111100000101000001001010010100001000001010111001
11001101000100000000000001011000011000100000011000101011000001110000110000000010001001100100100100000
00001010100100000100000000000001000010100001001111001101001001100111010011110001100000010010010110100
01000001110110011010010000001100000111000110000000100000001100011000000100001100010001010000100010101
01010000001010100010100000111000000000010010001110011100000100100000001000001001100100000010001101001
10001100100001001000111100000100110101100000000000000100000001001000010100101000100111011010100011001
10001000000000000000000000100100001010100011100101000010001100010001100000000001101001001010101000000
00000000110111100000100101010000000000100000000111011110101011010001000100000011000111000000100000001
00111100101000100000101011001000001010010001000100000001100000011000001000110000011000000000000101110
01110000000001010101011000100110010100011000101000000010100000000000000101101010100000100010010001000
01001001000010000000010010101010001100111000000000010111100000010100000100011100000100101000011000001
00000000001110010000001100100100010110000000110000001001000000101000101001000100001000100001110001001
00011100001100110010000100001110100001100101000000001000011000011000010000000100001010000000011000000
00011100000000011000101000100000000000100110000010110010010101100001100010100011000000000000000001001
00001000100110010100011010100100000100000000010000000100000100100001000010000100010010011001000011001
10000100010101100011010011010111000100110000010001000100000000100100000010100010000000001100100001010
10001011000100101000000110010000110100001000000000101010000000000001000100100110010100100001000010001
10010010000000011000000101000100000000000010101000001100100100110101110100110100010000000000010100101
10000110000011100100001010000001001001100000001000001011000000000000000000010101101001000000101000100
00001000101110000101000000111001000011001010101010101010000010011100101000000100000000000001000100110
00000101000010111001000100000010000100110100100001000000001000000101101000101111000001010011100001001
10100000000001110000011100000010010010100000001000000100100010010011000000100000100100000000000010100
00110000100001111000000000100010100001001000010111000100100111010100000101011111000000000000001010010
10100011001110010000110010010010001100100000001000101000000100110000001000000011011001001001001000001
00111100000001000010001000001010000100001001000010000000010000001101010100000110111000100000001011001
00001010011111010100001011010000010111010100000101000000010011000000111010001110110001000000010001000
00111110110100001000001111001010010111010000000010000011110000101010001000000101000100000000100110000
11011101000000110011001000010000010010100100000000010001000100000000000010100000010100100010101011110
01000000101011100100000000001000000100111000001011010000000001100000000000100100000100001110000011000
00000110000100000000100000101001000100100000100000000010000101000000101100010000000001010010000100001
10011100000110000011000110100010000000100000011000000000110011100000000001111010110101100000110000000
00000001001001010000001000000001000111100000000101101011000101100010110100010001001000101001001010011
00101000001001001100000011001111000100000110010101000010010011000000100011110100000001001010000010100
00110101000100000011000000010000010000010100001010000100100000000100010011000100101000000101101000101
10001100100000011011000000010000000000010000000011000110100000001010010001000000000100000100000000000
00101000000010100101000100011100001000000000010000000000010110101010001000010110111101000000001001000
10000010000011010101101100011000011100101011010010011100101011000011100101000011000100100000110000110
00010000000000100101000000100000000000100000100000001110001000000000000100000110000110110101010000000
01001111011110000000000000010111100010001001000000000100100010000000110000000000001011101001000000000
00100000101001000100000001110100000010000000001000010001001011001111101000010000111010110000000001001
00101010100100100000101111010100010000010001000010010010010000110010000001110000000000001000100001000
11100010010011000100000100000001010010001000100010010001000000101100001000010010000000101110010001000
00000000010101100100010000110011011010010000001000000000000100000001000111001010001101000000101100000
00010000001100110000000001010101011010010000000000110000100100100100000100000100100000010001000010000
00000100000101001011010101100110000000100000010100010011000000001000000001000100010100000000001110000
00111100011110000101000100010001001011100100010101100100011000010001101000010001101100101100001001000
00001000011000100100001000101000000010010001010000110001001000010000100000101000001100110100110101100
00100000011000000010000110001101100000000000101000110010000011000100011001100000010000000011100010101
01001000010010000011000100010001000000100110001001000001000100100100100000000100000010111011100110000
10000000011000110010010000100110000000011000000000000101000100100110000000000100010010001000010000001
00000101100101100110101000000000000010000000110000010001000001000101111000000010001011000000010000011
01001000000001100000000000000100000000100010101100100010011000100000100000100000011010101000001100101
00100001000100000101110010001010010111001110000011100101100000000100100010001110001010000000101011001
00000100001000010000000010000000010000000000011001101011111111000000001000000100010100000100000010011
11000001100000000001000010010010011101000000001000000100000010010000010000000000000100110001100000010
01101111000110011001000000000100000000100111000100000101000000010100000000011000000000010011000010110
10000001000000000011000000011000100000011101001100000000000011001001010000000000110010101100000010001
00001111010000100001110000000011111110010010000110001100010001111010000010000000010000010001100110100
00011010001000010110000010100000000100110001010100101101000000001000000001000010100010010000000001101
11011101000001010100000011001000000001101000000000010000100111000100011011100011100001000000101111010
00000000111000001001011001000001001010100010001001010100111000010010100000000101001000100010001100100
00100001100001010000000101000100001010101000000100000001100010001100000011100101100110101100010001000
10000001000000000110100101100100100000010011000000010011101010000101000111010100001010010001100010000
10011111000000011100000100100100001000110010110100000111000100101001110000001100010011110110110010001
11100000100000000001000000000010000100010110101000000001100001000100001000101000000000001000010010000
00101100101001111101000101001001000010101000000100000000001000000000000101001001010000010001001100000
00000000000011011010100000000000000000100100100101001000100000011001010000100000101001100000010001000
00100110011110111100110101001000000000011000100000110000000000000010000010000101001010010001000101001
00101010000000001000010001101101010011000110000010111101000000000000010000001010000000101001001011000
00000000000010100100110101000000000000000000000010011001001010101000010011100000000001100001101000001
00001011000010001000000010001100001010010110001000000000110110100001010101011001110010000010000000100
10001000101010000000111010000010000000010001001000001001001111111010000011100100000000001100111000010
10011000110010010100000000000000001010000000000000000001010100100100100001001001000000110010001000000
00000011001010001011100110001100001110001011000000000100101001001000000010010010000110100000101000100
00101101010000000100101000000000001011010000000000000000101010000110010100000010010110010000101100011
10000100010100010000011000110000011100110000011000110010001011111100000000001010000000000011000001100
10001100111100000001010000010010100101110100001000000010011001010110100010001100000111000000001001001
01100000011000000000101100011000101000000110000000101010001010101110000010011000000000110000101100100
01001101001000010000101000110111001000101000001000001111000101000001000000111000100100100010010100001
00000100010000000101100101100000000101111000010011000001001000000110011000001000001001001000000000101
01100000111000000100010000010101000001000100101000001010000000001100000001000001010000000100010000001
10101000110000001010010000100001001001001011100000110000000100000000000000000000000000000000000000010
10100001010100000000001100101011001101000000100000111000000100011000000111010000000001000010001000001
01000000000110101110110001010010001000000001010000000000000100000100011111100001100010000011000101000
01011001101010000100100001100000010111011100110000010110010111000000100001000100000010000000001001010
00000001110101000001010001110000001001010101000000000010101000111000000000100000000000010000101010000
00000010000000110010000000000010011100000011000100010001100100000000000000001000000010001100001000100
00011000000001100010110100010101001100000000101010110010000000000010001000100011000010101010001000010
11000101001110010000000001010000000001000001001000010000000000111111010001111000000000010000001100000
