00000001000110010110000000001010000000000000000000001111000110001001100000000000101010010100000101011
10100000010001000000011010010100000100000000100010000110010101000000000100000000110100010110110010100
00011101001000010100000110110010001100000000010001011000101000000000011000101011000001000010000010000
00000011000000000000010000100000010000000000111001100101000000111010100000010100001001010010000000100
00010100101001010000000000000001000101110000100001001100100000000000000010000001000010000100000000000
00000011101110010011010011011100110100110111000001011000001001000001000000100001000000000011000111100
01111001000000000000000010000010000101100010000000100000011101100000010011000100001001101010010000010
00001100001011001101100000111111000101010100001000011000100000100100110010000000000100010110001111100
10000000001000100101000100001000100001100100000100101100000100110100110001100001000100001100101000010
10000011010000100101001000010000100101011000000000010101010001000100001000001010001000000000011011011
01000110001000011000100001010001011000001000011001000100000100100010000000100000000000000001000100000
10010110001101000011000000001001100101001000010011010000010011001011000000000101000001101000011001110
11100001110001100110000010000001000100001010101000110000000110001001000000001000000001001000000100100
11111111000100110001111000000000100001001001000000000100000100000011101100010010011111000101101001001
10000100000010100000110101010000100100001110101010000000010000100001100110100000000010000000001010100
00000000101000001010010010000001000100011000101011000000000100100100101010100100111000000000100001010
00000000110110101000001000101011000000110100011010001000000010000001001101000000001000000000010101000
01010000100000001001110000010011010000001110000101000100010101000001110111101000010010110000000001100
00010001000100001001100010001000000010100000001011000001000010000000001000000000000001010000000001010
10111010000010100100001101000001000001011000000101100100000000011111100000000000101100000110011001001
11000110000010000010101000010010100101000000000100100001000000000010000100010101010000000100001001000
01000000001001000001100000001101000000010000010000101000000000001001010111001010001000101000000000011
01000001101010101000101000100100000010100000000100010001000010111101000000110100100110101100001000011
00000000000000001001010101001001000001100110000000101000011100010101000110000100000000010000000100011
10000110011010010001000000010100001110001100001000111000000100000100100010000000000000000001001010000
10000011001001010001101010001111010101100000010001010100100010000000000100000000110000000001000011010
00000110100000000000101100001000100100000000100000000101100001101100000010101000001010000110000010000
01111110001000101010110100010000000001100100000001010001100010000000000110000010100000101111100000100
00100000010010010101001000000110100000000011000010011000010100011011100000001001101001000001001000101
01110100111110100111010001011011000000001000000001111000010100011010001000000110110010001000100011011
10011100011001100000100000001011011001001100000010100100000000111001010110000100000100010010001000000
00000010010000100000000001010001000101001101000100100010000001101000000100000000010011110000000100000
10001010000000100000011101000000000000100000011000011000010000010011001000010000011100001110001010101
01010000010000010010111111100100000101110000000110000100000101011010110000000000100010100001010001001
01100001000001001000001001000100110000000001010000110001100100101001100101000011100100000001000000100
00000010001100100001000010010100000011101000000011000000010001000100000100010100000111001101000001000
01000000001000110001011000101000000010100010000000000111100000000001100010010010000000101000100010001
00000101000010010000110000000000101010001000011111010100011100110110011001001000000111000011000101000
00000010100001000001111001000000011001100000001101000000011010000101000010000100100000010001000010110
01010000000010110101110011000000010000101010010100000100101000001010100010011000000000001000001010111
00000000001000000000110010000110111110001001000100011000010000100000100010001000000000110000000010010
01110101100001000011000000000101100000100100010100001000010000011101011100101000001000111010100100000
00100001000100000101001000111000100001000000000000101100000000000010001000001000101000000000010000000
11000000100000000100100010001100000010100000000000000010011100001000010010100101111001000000001110000
00010000101100010100100001001010101000001110100100101100000011000001000000000000100001000011000100000
00000100001010100000100100101001110000000100001000000111000100000100000111000010001000001010110011101
11001000000101000000100100100011000010000110100010100000001101010000101000000000101010100001110000001
00001100000010000000000100010100000100100110001101010010001000010000000010001000100010011010000100010
01000000000000110100000010000010000010100001001001000001011000100011001000101000000101011101111001101
10100111010100110001100000000000011001011001101001110010000101001010000000010100001101001001010100000
01100110100110000000111000100100000100000001001000111010100000100000100001001001000001000100001010001
00001001001001100011010010111100000000000000110000110110100111100000011000010000000100000010000000100
10100000101101000001100010010000001010010000000100000000100001101011000001000010000000001010000001110
00001000110110001000000110101000001010000100000001010000000000000000100001100100111000101101101001100
00001001010011100000000001010100101000100000010010000000000001110000010000000010001000100011110001000
01010101001111000100001011000000101000001100110001110001001000000101100010010001010001001000000000000
00110110110001000110110000000100000110000110110011010001000000101000110000100000101000101000000001000
00101001111000000010000001000001000010010100000000001010011001010001001001000011101111100010000001010
00100000101000101000100100010001100000010001001101011001100001000000000010001010011000100000101000000
10000000000100010010001000000110110111100010010000110000100001100000001000100000000000010001010001000
00000000000000001000000110000011000001000001110100101000011010011000001001000010100000000001011001000
00000110001001000000100000100101000100110000100100010000010100011000001001000111001111011001000000000
00000000010101000000011000001000101000000001111001000000100001010000010000100010100010010001010110110
10000000010110000010100110100011000100010100010000010010000000000101010111000000000000100001000000000
01010000000010011000010000010000100001101011110000000000101010110000001000000011000010010110001001000
10000100000000000001101010001010100010000001001000100001000000000110000010010010000000100110000010100
11000010000100000010101000011001100000001011010000010000010001000000000001110100101110000011000000001
00100111100001100000010010100000000100100010101111010100000000111111001011001000101000001000001010001
00010010010010000010100001011000001010010010000010110011000001000010000000100010000100000001000101000
11001001100001011100010000100101000010100000001001010100101000100110000001000000000000100001100100001
00011111010011100001000010000000001010001100000011010110000000000010000110100000000000100100110010010
11000110000001000100000011010100100010000011000011010001001001010100100000010100000000100000100101000
01101000111000000000110000001010101000110000000001000110011000011011000000010000100100001110000101100
00000000001100110010110000101000001000000001100000101100010000000010100000010110000101010100000000110
10000000000000000000000001000100110010001100000100010001101000000010100101000010000000000001100001010
00001101000111100000100101000100010000011000111000011000011110010000100010001010101000001010001000000
00101010000000000001000100000010100001000001100000110100000100000101001000000000000000100010000100111
01000010010001000011011100100110000001000011000001010000001110110010110100010000000101000010000000000
00001001011000000101000001110100001000001001011000001100000000110100011000011010010110101001000000001
10000000100111011011000000001001010100000001110001000010000100010001110000000111100001010001000101000
01000000010001010111001011011001101000010000000100001011000000100000000010000001110001000010000010110
01100011101110001111100010010001100101101010100001011000010010010010010100010100001010100100000110001
10000000000100101011010010000000111000001011000110000010001101000010000110011110000011000100110001010
00000001011101100011111010100101111100100010011001100000110100101000101000010000100101000001001010001
00101000000011001100000000010100010100000000101111011000100111110000110100000011100100001011010100000
01101010011000010001001001011001100000100000110001000100110100100100100010000000100000000001110000010
11011000100000100000111010011100101000010000001011011010000100101000000100100001100000100010000000110
00000010100001111100100001000100001000001001000110100101100000000010000010110000110011000100000000000
00010001110001100011000010001110100100111011110100100011001100111111101001000101110010101101110011000
10000100000000000010110010101010011111000110000010001000100001100001100110100010100100010000001100111
00111100000000000001000000000100110001001000110001001000011100001001100000100010111001000101100101000
00000000011000101100100000001100000010001100111010010001000000000010000000001110001001000000000100000
10001000000110000101100011010000100000110111001110111010101111011010101000100001001000001100001100101
00111010101000000000100000000101011100000000001011101001100011011001001100101100001000000000000000111
01100010001000011100000110000011000010001001000000000100000000100000010010010100000000011000100010101
00100000000001001101000000000100010100110100000000011000001000000010010001100001000000001110000011000
01000100000101100100000000000000001000001010010000010010000100000010010000000000010001000111010100100
01000010000010101000110011110000010100011100011010100000110010100101001010000001001110101001001100100
10110010010000000100000100000010100000010001001011000001001000010101100001000101000000000000001011010
01001010010000100000000010100001001100100011010000000110000101001010100111000100000011000000000000000
00000010001000111000001101001010000000110011001010000010110000001101100010000000011001001010000100000
