00000001010110001010110000000000000100001010000000000101001010111101001000001010110001010011100000010
00011000000011100000100010101000000100100001110111001010000010000001010000011001000001100010010101000
00000001001000000100000010000001100000011110000010001000001000100101001111000001001101111000111010110
11000001100000110101000000100011011000000000000101001000000111111000000010000100001000000000000010101
00000111011001000000100000010000101010100100010101000100000011010000110010000000000000011000001000001
10100100001100011000010000001101001010100010000011010111100110000010000100100000100010010001010101011
00000000100010000010001100100001010000101001110000001001010101010101000000111001011110100011011000001
11000001011100100001000010111010001011101001110010001110001101000010000010010000000010010100011100110
11001100010100000000000000011000011110001000001000000100100101010001001100111111000010110001000000000
01000011110010000000000100001001000011101000111000001010000011010001010000010001100111000000100100001
00010100000001000010010001100000100101000010001010100001000100100000000001000001110001001100010110010
00000001000011100100101000000000101101111001001000100010000001000011010110100100001000000001010000100
00001000100001010000001000000000010000000000000101001011000000000000000000100110100001000100110101101
00001111000010011000001000000010110100000011000000001001000000000100100001001010000101000000101111010
11010110101000010110010100100000001000110000010100001000001100010000100000100010100000100000000010010
00000000101000000000100000000010100101110111000000001010000110001000100100000000001001000010000100010
00000000001000111000000000011011001010000011001010011010100011000000000001011100010100000000100101110
00001101011111000000001010110001000011101000111001100110000000000011000010000001100100101000100010010
10010010001000010000111101010000000000010000000000010100001001000001010100000100000101001010000000000
00001011000100010000000010001010001011010001100100100000011000001000000010000001010000100000001010001
11011000100110110000000000000010001000001100100000001101100011100110010000110110000100011010000000110
11111010001100000000001100100010010101001100001000000100010101000010010100100010010001010010100000001
00000110010100000010001110010001011110100100001010000001101011000101000100000000111100100011100010000
00110011000100101111000000100010110010100000000000010001001100001000000000110000000010011011000000001
00000000000100100011101000001110010001100001000101001010000010100010010001001101011001001100000011000
00010101010101001011000110000110011011000110100111000000100010000101100100000010000110000011000011000
00010000010010000100000000001110110101000001100001001010000010010000010001110110011101110100000000000
01011110100001110010100001101011001000000100100000001100001101000010000010000000010010001001001000000
01001000100100010101100000000110100010101101100101000000000010001110110000000010111011100000000100000
10110000010100000110000101110000000010100000000000001101010100001000011001000110000100000000000011010
00100000010100010000011010000100111101000001000010000110110100101101110000001001100001011010000000000
00110000100010000101000000001000001100001000000000100010000000000000101110000100000010001010000110001
00000100110001010000010010001100000000010010000000011000010100100000000000000100001000100100010010000
00001010001110011110000000010100000010011000000101011010100100010000100000001101010100000000000101010
10011000000000100000000101100010010000001101100110000111000000000000000010000100000010100110010000000
11100001000100001100000000110000000000011110100001000100101000000100000000100001010100100010000000111
00110101000100100000000011001001001000000001000000010000010011010010010110100011101000000001000000000
11001000100000111001001000010101111000000000101000000000001010001010011100000001000000000010100000011
00111001000001101010011111100000100000010000100000010100001001001000001100101001110100000000000111000
00010000000000010010110011100000000000000111001100010010100000000000000100010000000000000010001101000
01001000100011010101000001010001011010001010111100011001001000100000000010101100010001101001000011000
10001111000000001001001101000001010100000000010100000000000010001010000000010000011001000000101000000
10111011111101010000011101011000011000000101010010000000000110001001001010001000110001000000000110000
01011000000011101000101100000010100001000001000010001000100110010000111101100101001110010000000011001
11010010100000010001100000100001100101001111100110101110000000001000000010000000000110000110000001000
00001100010000110111110101101000001100010101000000000100000101000000010100110000100001000000101001100
01000100010010001000000001111100000010101000001100100100000000000011011101010000000111000010011011011
01000011000010001010000101101000010000100010111000000010101101101100011110011000100010010000100000000
00000000001010001100110100000010000101100110000100001000101110100000000010010000001000001100100101000
00000110111000000110011011000010000000111010100000100100000010000110111010100000000010001010011000001
10000010101100001010111011010000100000001011000000101111000010100111011101000001100101101100000010001
00000000100000000100111110000000000000011000000000101010000100000000101001100001100110010000010110110
10000000000011001001010100000000010010010000001000101000000100010100001001010100011001001000101101000
00000101010001101010001000010100000000101000101000000010000000010110000000010000000000100001001000110
10000100010100100101011110000001001001100100001010010001001010000000000000000000000000001111010100000
10110010000000000011100000000000000000000010110000100000100010110010000000010101011010000100001110000
01100100000110010010000000110000000100001000100010110000000001100000101000000100010110000011001001101
01101000000011100000000000001000000001010100010000001101010000001110100001000100100001000100111110001
01001000100100100101110100000101011100010000000110010001000000101001001100011001000100001001100001000
00100010001011100100101011000000100100000010000000000010001000010000011110000111010100011000001001110
10001000000010111000100111111101001000100101100000000110010000000001101011010001110000000000000010011
00101000000000000000000100000000000000000000101110000001010010001000010000010000010001000010000000000
10111100110000110000000010100110111111000100010111100000011100100000100000100110000000001000110000010
00010110100010001100110010000001000100001011010000000011010001000101000101011000000000000110000111100
01000110000000000000000100001000000010001001100010100000010000110111111011010110000000010000111100010
10010110001101010001000011001000001100110100001000111101000001000000000001000000000000000001100101010
10110000110100011000011010010000010011011110000011000100000101001001000001000000000000101100000011000
00010010000001011010000101000000000000000001000010001101001000110100010000000000010100000011000000000
11000100000011100110000001100000000010001000010110001010100001000001101110010010000101100010010000010
01000100000001001000000010000001010000110000001010001110001101000100110001000100001100001100010101100
00000100010000000101000100011000111100000000000010110001001011011100110010111100100000110000000010000
10011010001010100001001000100000000101110000001110000001011000001100000001000010110000000111000110010
01000011000110001000000000000110101110010000000000101000110011000100000000000000000000010101100001110
10110010001001011000100010101111010010010000000011000000001001000000000001000001000100000110001000010
00001100101001000100101001100000100001000000011101011000000110000000000000100100100100100010010001001
00010000000000000100000101111101011110000011000001101001000000011000001101010000001010101000000011000
00001000000110000010100100000101011101100000000000010010111001000001010000101001000111000011010001000
00000011000100010001010010100110000000010010110101001100111001011100100000011100100100000000110111010
00100010100000001000000001001001000100100000001000010001100000010100000000000110000010000000000100010
01001010000011100001000010000000000001110010000111001010010000101001000001001101000001101000111000100
00000000010100000001000000001111100000000000000000111001010000110100001101100000110110011010100001000
00101011000000100110100010001100000010000000000000111011000101001000000100000010000001000100000011101
01010000000100100001101010000001010011110000001001001001101011010110000100000010110010010010000001101
00011000000000001011001001100010110001000000000000110000100001110101000001110100010000001010100000001
10100110000000011001000011010101000001010000000001000100011010000001100001010000010001000101001100001
00001000100000100010001100100010000000010010000110100001110010001000010000011100010000000001111000101
00000000001111001000100100000000101110101101000010110000000001000010001001001000000101111100000101000
01101001100000010110111000110000010010001000011100000100000000010010000101000001001101000000000110010
00100001000100000001101000100000000001000000000111000010000000011000000000010010010110001010100000010
00110000000001001000100000001100000001001011000001100100000111101101000000000010100010011110000010000
01000000000001010111000000001011000111000000000001100001110010000001110101000001100101000100000010000
00000100100000000101011010000010010000010100100000001011011100001000000110001010110010010000010000000
11010011000001001000100100000100000010100011010000000000010111110010000101000001000111000110011000001
00101000100000000010000001101000101001001110011101011000001000010000000000010100000010000000001001100
10010010010001100000100101000000100100000001110000101001111000000000110000001011000000101000010010100
00010000001000000000110101001000000010110000000010011001001011000000100000010010000010000000001001100
11000010001100010010010001100101000010000010001110000000001000100010010110010010000000000001101100010
00000101010110100001011100000100000001110110011111000101100111001000000000100110101000100100000100001
00010000000000001110110010100000010100000011100100111110101011100101000000000001000011000001000000010
10010100000000101001100110000110000110001101000001011000000010010001011010100010111100011000000010000
01101100101000001010010010100000010001000000000010000000000100100010100000000010011100000000000000000
