00001010001000100001101000010000000000100010100000001000100000011001000000000010001000110000001001000
00001100000100001101001010101000000000010000001100011101000000000010001011000100000000001100001000000
01100001000001100101001001001000001100000100000110001010001000001011001000000001010100000010011000010
01010010001000000010100001000100111100101100100100100000010000010111000110001110010100100010000010010
00101101101000010001001100111110110001010010001001000101000100101100001101001101000000001000001110010
00100000100011010000000000010111001000001110010100000000100110100000001111101100110000110000000111001
00000000001101000000000100000001011001000000000000001001000000000011100010110100010100011010100011100
10000010010000000100001001000110000000000011001101000100000001101000001101100010001000000000111100101
10010000100000000011110001011000100000111010000000000100000010100000100000000000000000010010000000001
00101000111011010010011010100001100100001100000000010000000000100111000001010011000100001010001011011
00000110110111000001000001000001111000010000001000000011000100110001000000010010000000001000000010010
01000000000000000001100101001101000101000000010101000000100001001001000110000101010110011001100000000
10011100010001000100100100011101100101100000100000000001000000000000101010000010100010001000010100100
10000100101101011110000010001000000101000110000000011100000010000001001010000011000001101011110010101
11000100000100101100101001000000001101011000100000101010000000010000011001010000000000100100000000101
00000000101001000010100100111000000010000010010010100101000101011001000010100000000001000001100001110
01000100001010000001110000000110001100100001000000000110000001001000000000000000000010110000010000000
00011000001000000010000000001101001000110000001001000011111010101101000101001000000111000010000011011
00010011100001011010101101001101010000100100110011000001000000000001000111000000011010011010100111100
00001111000000000000100100011100110101000001001000010101010000100101000001110001111100000100100000000
00101101011000000110100000100001000100000100000001000001000000101011000010000010110101010010000001011
00010010001000011000010010101101000110001000000101000001000110110000101000110011100000001000011000111
10000000100001000010100001010000010010000001000000000010110001001000010001000000110000001110110001000
00100000111100000000000000000000100001010001000000000110111010011001000000000011000100010011100110000
10001100000010010001110010000000110000000000011010000000011000000000010010101110000010000000001000001
10000010000011100001000000011011100001100000010010100001011110001111000001100100000000101111111001010
00100000100000000111100101011010101110000100100100100100100001101110100100100010000010001111011010000
00110101000101001000000001001010001001000000001110001000100010010001101000011100111100000100101010000
00000001000011001011010010001000010000001000111001001010001011100000000000011001111010000000101011000
00000001111010001000010000001111010111100000000110011000000001000010000000000000010000100000000100111
01101011101000101101000000000110010000001100100011100100110010001010000110010101000010010000100010100
10000101000000000011110001101100110000000010000010000001001000011011010010000100011010011100000110000
00000101110100010100100101010010000100000000001010111000100100000001100000011110010100110000011010100
01100111010000010100100010000110011000000000100000010001000010110010000001100010011000000100100000100
10010000001101100111100010010010001000000101011011110100001010100011000000000110000011010000010001100
00111000111000000000011000001001111000111000001000101000010011011100000000010101000000000001010000000
01000000100001000000000010001010101110110000100000100001110101000000100000000000101001100010011000011
01100111000101100010001000001000101001100010101000110001100000100001100000101110100010001001001000010
01101010101100010100001101001000100000100010100000011001000000010100001010011000111000010000101100011
00001000100000010000010100111001000001101000101000000110000011010000000000000010100100000100010110000
00110000010010000000000000000010100100010000100100100011010000000000110100000101010101010001001110100
10100110101100101000110001000110100010001100100000100110100001011011010010101111000000010100011011010
00010000100110100010000000110001010111000000001010000111110000100100000010100000001000000000100000001
01101000000010001100010000110011101100000001001100000001010111011000000100011001111100011000011001000
00000100000000000011100000010000000111010000000011001000011011010000010011000111000000000100100001110
01100010011011100000010000000101001000100110010001010010100000000000010001010001110000000010101111000
00001110000100110100001011000010100101000001100000000110000000110100011110110100010000000010111110000
10110000001010000101010000000101100010001000000010001100000100000101100110010100010011000101100010000
00010100010100010100000001000000010001100010100001100000010001000000100100000000000000000001000001011
00110000111001100000101010000001011000110000000100000111000000101001000000000001011111010000000001000
00010011100000000100010010001011101001000010101101010100011000010000000001010010000000000001011100010
01000000001011011101100011010010000100010010000100000000100000010001000010100101011010100100000110100
10000100110100100111010000010010001100000011001000101100101001000010010010000101010100001100001000000
11000000100001000010000000100000111000100010111000000001100000001100000011000000000100101001000101011
00000000010001000000100001100000010100000110000100110000000001000000000000001110000100010001000000111
00000010100010001010000100101010000100010100010000100100000000100001000000001000111000010100001001100
11000000101010100000010001001010010000001100010010001011000100100100001000000001110000000001011000100
00000010010101001000000001000000000000000010001101000110000100010101101000001110101010011000000000000
01101010001110011011000111100100001100000011000001001000100010001000111110000001000000011000000000000
10000100010011101000001000110001101000110010100010001000010000000011000010110110001000101001110101000
11000001110000010010010000000001001000111100001010000010000011011010000100110000110101100011110001101
10000010101101100000000100000000001111011000100000110010000010000011000101111010010100000100001001001
00100000001101000110001000000000100000000100011001110000010010000000101100000000010010010001000001000
00000000100000000000000001000101001101110101000001101000100010010001100001000001001010100001010100000
00100000100010001000100010100111010001000100000111100101001000111010100001011011111000010101001000011
00010100000110000000101000010001010001110011001110000001000111011001000011010000000001100101000000101
00000000001000001001001000011100000101000000000000000000010100110001000011001011100001110000000011100
10000001101110010010001100000000100100100001000000110000001000000001000010000001001000111000100100010
10011101000000001000100001000000001100000000011000000110001000001101111100101100010000001100000100000
00100100000110000001000000001000000100000001000000000010110100100100100100011010110110000001000010000
00010001010000001010000100010000100000001010000100000101001010110000111001000000000000110011000100011
01000101000011100001000000100010100011010100010000001100000000101110000000111000010110000001010001110
10001101100000100111001000000000000100010001000000100100100100001010000001000000000000000101100001000
00010011000000010100000011000000010010100001001000010000011010101000010000000001001001000010011001010
00100000001000101000100011001011110000000110000000010110001100000010111000000000010000000011100100110
00000010010001110110000101001000000110000100010000100000101011000100001000010010100000000000000000110
00001000000100110010011111000010000001010010000110000010011001000010101000011110100010000011000000011
00000100100010101101010100100010001010101010110010010010110000001010000100110001000001000101010010100
00100000110001011001110000010100000000001100101000000000100100001111000010000101100100100010101100010
00000010000110101000100000100000000011100000100000000010000100000000000000001010000100100000101110111
01010000000000000001001010001010000000101001100000100010001100000000000010000001010110000101010010000
11010010100111010001001101110110000000000001000110110100100001111000111100010010000001100000100000010
00100100100000100001000100100000001010100100000001101110100010010000110000101001100101001100000101011
01100101000000010000000110000101010100000000000000000010101000100001001100100010100110000000000110001
00000010010010000010000111001010000101010001000000100001100010001110110000010100110101010010101001001
11000000001011000100000000101000111010000010101011110000011001100001000101000010000011000000100000100
01100110100100000101110000010000010010000000000000000110000101000011101001000000011010000111000001000
00000010100000010111010010100000000000010100000001001010000000000010101100000000100000001011000000010
00010010100010110000000100010001000110101011000000001100110000000000000001000101000001000000000000010
00000100110000000111000000000000000000000000000000011001110101000010000111100100001010000100001110011
10001100000110000001110101001110100000010010010000110000000100000101000010010100000010000000100000000
11000000000000000001100000100010001000110000101000000000000000011001100100000000000000010000110101101
10100001100011101100100000000000001001000000001001000110011000010010001000100000110110000000011110000
00000010001100010001000010001110110000001100000000001000000000000100000010111000100000011000001100000
00100010000000110000100101000000100100000101010001100001001010000001100000000010011000010001000001001
00100100100000000000000101000100000000001000011100000000000110100010001001100000011010010110111001000
01001110100010000101001100001100101010011101000001000000011010001010000101100000101110001110000111011
00010010010000000101000010001000100100001000111000000001000100110010110100010100001110100100010000101
00001001011100000110000010110101011111100001000101001100001000000010000001011010010010001000010000100
00011100001110001100001000000110000000011000010100101101000010000000110001001001000000100010011001110
00000010000001010100000000000010000011001011000000000000010001000000010110000000000000000100000000000
