00111010000001000101100100010000000010001010100011000000000110000100000000100000000011110100000010010
00000110101010001001010100000100111110010000000001100001110000010000100000100000010110100000001010000
10001000000111011011001000010010000110001000001000001100100101010000110010010011010001011000001011110
10111100001001000000000000000001001000011001000001010000110000101000110101000011000000111001001100000
10011010000100010000001000000000000011001111001010100000010000110001011001001000011100000101000000111
00000100000100101101000110000000000010000100000011010010000000000010001100000011011000100101000100100
10000000011100110100100101011011100000000101000100110000100011001010100101010001001000000010000000010
00010000000111010010010001001110101011100100101001010001010101000010000110010100000000010000100010011
10000001010000000000110011000011010000000010101000001001011101110001100001010000010100001000010111001
10000000100000000000100000100001101100111110111011000101001001000000010010001100111101010100110000011
00000100000100100101000000101110101000000100100000110001010000001001110101000101011000111100010011001
01010110101010100100110100011101000010000010010011001000010001011101100000001100010110000001001100000
00111000010100100010000001100000001000110000000010010001101001001100000010000011000100001001010101001
10110000100000000011000101010100000000000001000000100000000001111000001000000100000000000010100001011
00110110011110110000000011100011000010001000101000110101100000000011001100101010000010000000000010000
00100000001001100110001000000110010110001000010101110000110001000000011001010011011100000000000001000
10001101011001110110001010000101100000010000010010101100001100010010001000000001000000000100000011001
01001000000100101111010001010011001000000001010001000110001110000000010000000101000001010100001000000
00000000110101010100010000010011000000010001101000101011010011001101000000011100100110000001010011101
00010010100000001000000010000000000000010001010001100010100100000100011101001000001111010000000000101
00100000010001101010111010000000100100101000111110001100000000000001000111000010100000010001010010101
10001001010010100000000001100000100010000000000001000000001100110001010100100110101000100010100001100
00110001010001100110000100000001000000000000001000100001010110010000010101010000110011000011010111000
00001100000001000100000010101110010000000100000101001101000110010000000110000000000100000001001011000
01000101101000000000010001100000100010001000001100010101100001010000101101000100011100000000000010100
10000000000100100011110010001010000000001010000110000100000100010110010000001000100011100010010000110
01101100101010000000110001110000001001011001010100100010010110010011111101110010010000000011000001100
00100001100010000000010001100000000111001111001000010000100110100000000000010001010010001100101000011
00001010110011111100001110111011101001110000000011001001000011000000010001011010011000110000100001000
10001010100101000001100110100001010100011001011101010101100000000101000100000010000000110000011000001
00011001100000011001010101000000100110000010000000000100000001100010011110001010110010000110000010000
11000000000001000001100000100010110010101000000101001000001001000100000010000000010010000001000001100
01100111110101101110000000001001001001110001000000001000110000101010000100000100000001000010111001010
00000100100111101010000000000000100000001000000010000100001110000000001000111010100110011001110100011
01110011001000000000101000010000010101100110010000010110100101101000000000000000101000110100011110000
00000001100000110111000000110100000000000100100000000000010110100110000010111000000110000010001010001
11000100100000001010001110000001100111000001010001100010000010101100000100001111100001111000010001000
00010010111110010000000000000001000101100100000101000000000000100011000011010100000000100000000100000
00000000010000000011001000000010100000001000000010010000100010001000000010010000110000000110001110001
01010100010000000110010000011001100000101100001000001100000000001000100100001000100010000000000000000
10010000000110000100000001000010100000000100001100000110010110011001000000101101000000110111100000000
01001001010100100000100000000000000001000010110001000010100000100010000001100001001000110000010000100
10110001001000001010000001001101000111001101000000100000010011100010000101101001101101100000101000000
00001000100000100001000000110000010000000100111010010000100011100100110010000110000011100110001011000
10101101101101010000100000010001000000001100101000000111000100000000011100000000000010100010010101011
00000000111010100000110000100011101000001001010001001011010010110000000010001111000100000100000001100
10100000110011000101010000100000000101101001100101000100000010000001001000111000000101011000000001100
00001000000100110000110101100100010100001010110001100101001001000001000100110011011100100001110000100
01010010000010000000010000101000100000010000101001000000010100001011000001100101000000100001100100010
00110001110011010101000000000000001000000100001101000010001001010010011001000000101000000001000001110
10010000110000011100110000111010010011100010100111010001101000010000001100000100000101010011001100000
11000001001000001001101100000100001001010001110000110010011011001011001000000101000010001000000000000
11000000010000000000101100001100000100100101110001010001011001111000100000101010000000000100110000000
01001100010000100100000000101101111000000100001100001000011001000101011111101001000101100100000000100
10000000000110101111000000110000001000100100111000000110011000110101010011100110010001000101000000000
00000001001001000000000000000001000101010100000001000101001001111010100000000000010100010101110100010
10001110000110000001100000010000110011001001011010100000000011000000110000100100010000000000001000100
00000000000010011011010001010010000000010101011110001010001000001110001110000101000111011000111000110
00000000000000100001000000010010110000110010101100100000000001000000001011000100000100010100010000000
00000001000000011000011110000000001001000000101100001000000000100010000001000000100001000000000010000
00100101011010100000010101010010000110100000101001010000000010011100111000001010001010000000001000000
00000001000000100110000111000001010000000010000011101110000000001111000000100101010000111001101000111
10000001000011000001110000110001000100110000001001010000101000000000000001010001000100000010010000000
00110101110111111000100000010001100000011000000100000000100000010100001000000010001001010001100101101
00000001000001000000001000000000000100110000100001001100100000000111010011001100010000110001011100110
00011011000011000001000001101010010100011001000010000001110000011110010011110100000000000000001100001
00000110100100000100010000001011011001100011000010000000001001001100010000100100010010011100000000110
11001001000010000100100100000011001100100001001011010011110101000000000000100010001000111000011000000
00000100010010100001110000001000000000001000000110001011011100100010000000001101100001000100010100010
00000000000000000001010010000100101100010110100010000000010010101110001000000010010001010010100010110
11001001000000011000010000010010100010110000000000000010000000000011011000000001010000001100000100000
01000000100000010000010000000000010111000110010001001100100100000100000001101100011100010000000001100
01010010000001000100010000001011111011000100010000000111000000000011011000011001111111000000111000111
00000111000100100011010010010111000101000011110000000101001000000101100111101010000000011100100001011
00100110000100000000000000010011111000110000000101011001000000100010000000010000000011010011010000111
01010110010000000001011001000010000000100000100000001000101100100000001001001001000000101000001110000
00111000100011110110001010111000110000100111000001011000000011000000000000000001100000001100000000011
00100010000101100000000101001110001001100000111001100010100000001000000100000000100010010000000010000
00100001000110100100001011000100000001001000010010000001010100100101011010100101001001010100010000000
00110101001010010010010110000010100000000001000100000011100000001011100011000000000100000000000110101
10000101001010000111010001000110101001001101000011010011000000011000110000011111100000001000110101000
00000010100000001100000100101000000010010100000001100000000011011100111101001010001001100011110001000
11110110001000000010010100010100001000000000100010011101010000100000100000000000010010100011100111100
10000101000000000000101000100100110110100000010101100000010101100001000000000001000111001001001000000
00010110000100000000100000010000111000100010000100000010000100010000100000000001000001000100000010000
10011010000001010010000000110100001000010101111100000010101000101010010000000011000011100000111010011
00010010100010100000000001001000111011011101101000000100011011100010000000010011100000010100100010101
00010100000011000101100010101010000001100101011100000100000011000000000001001001000000110000011000000
00000010101001100100000000000111001110000011000001101000011100000100010001010001100010010000000010000
11011000000000000000001000001001001110000010000100000000100010001000110000101011100000110011000000010
00000000011101000011001000010000000100000001001010001000000001011111100000100011001000010010001111011
10110101000001000110100000000001100010001100000000000000010010100010001000010101000001001000001010000
00100010011010000000110010000001000010100011000101110100000000000000000000001001011000011111100100001
00010110000000100001000011100000001010011001110000011101000001100100101010100010001010010001110010000
00011100011001011001110011010101010000000001100011100100010000000000000111110010011000000000001001001
00000000000001011000100001100010111101010010100100100101001000100001001000000101011100000100011001000
00100111100000001000010100000100010000000001000000010001100001000100001100101011100000011000001001001
00110000101011100000010000000000000000000001000000000100011011111110000100100100001011010010000101000
10000110010001010000110000100001010001111000010000001010000100001000010001011010000100010000001000000
10000110000011000101000010000000101000000010000001001100100100110000101010111110000010111100000010110
01000000000001001000111000001000000000001000010100111000000100100000100010110100000100110000011010010
