00000000000010100000010010010010011001001010000110100010000000000010100001000101010000000001000001100
00001000000100000000110100101001001101011011010100001000000111011011001000000000000010000010001000000
00111100101011100010011010101001010000100000000000010100010111100001000000110100010010010111010000000
10001001100000000100010001100101100010010000100100001001101101000001011010110000000100011010001000001
10000100100101010000101000100010100001000100000100101100001110010100000100100000000101000010010000100
10000101100100000000000101000001100001110100000000000011000001101100000011001100000000000000011011101
00100001001000100010000000011101001110011000110010001010111010101100000010010101010010010100000010101
00001000000110100001000000100000110001010111000001000000100100001100011010111110110100000101001110001
00010010000001010101000011010010100110100000101000100011000000011010000000000000001101010010100100010
00000100010000000100010000000010100000111001110000000000000011000010101001010001010000100000000000000
10011010000000011100101000100101000101110100111110010100010000011011011000010010110011001110000010000
00001000000001010000010000101001110110111000111100000000000010000110001101001001101000000000101101110
10010010110010001000100010100101001011001100000000001000110110000010000100001100001101011010100100101
00001010100000000001000010110100110000001000101010000001001000010000100000000001010100010110010101001
11100101000010101011101100010000001010000001011011010001000010001000000001001001100110100111000101000
00111110000000001101001011111010011000110100000100100001000000000010011010011001000000010000000000001
01110000011001000000100101011010100111101000000000000100100000000000000000110100000110110000000100101
01001010001010000000100100111000011010000000000000001000001100010010010101101000100101000111011000100
10000100000010000000010100010010010010100000101001111000001001001000010000010111100010001100000001100
00101000000000010101111100000100001000000000000100100101100001000000000000000100000001000100000001000
11100101001101001100010100001010001010111100010100000001000110010001001101001100000001010100000001101
01001000000000110000001000010000011100100001000100000000000010010100011001000011100001101100000100000
00001100011100000000001000100110010001010000000110001010001001010001000000010010010000000000000100100
11000000011000110001000011100000001010001001000001011010000101010001000000001110000100110010100100000
01000000110001000000000000100000000000110001111100000000000010011000000110000000010100100011001000000
00101111110000100001000100000100010010101000100001110110010000000000111001000000000110001010111000011
00001100000100000001100000100000100100001000001101010011011011100101000010000110001010000000100000100
01000000000010101111000010100000000001001000001001110000000110010011100100110001010000101010001100010
00010001000100000000010000010000001010100010000101000000000100000010110100100101000000100101000010110
00010000000100100000011000000100010100010000000000000010010011000010100000000001000010110000100110001
00000001100100100010010100001010010001001000110001010010101111100100000010000000001001000111010101000
00100110011000110011100100001010000011100001010000000011001010000001000100010110011001000001000011001
00100100010000010100000101001001000010100100010000111101101100001001000011000010111001001101000000100
10000000010001000000001001111000010010101100000000000010110001100011100001000010000001110010000100010
00010110100001001000010001110001100000001011001100001000101000010000010000110011101100000001100001000
10001011000101001001001000000000000000100011011000001000011000100001000010000111101010000100010000010
11010000010000011100101011000000000100100100110001111000101100000100000110010100100010111000100101111
10110010100000101000101100110010000000110000100000000100000011000100010010000001111110110000000000000
00100000000011001100010000111100000000000011010001000000100010000000100001000010100010110000000010110
01000000000000000000000010011010100000100001000000001010000000010000110010110010000000000000000101101
00010001000001010010100111100000010101100110001010000100001001100100010001000001010000000000010110101
00000000011110010110010000110100000000011100100100010000100010000010110010001100100000110001000001100
00010000000110001100110111000000001001010100000101000000100011000000000000100000101000110000110001000
01010001001000011110100010001100110011000000101010011011000100100001001010111100000000110000100100110
10010000100000000000100000010000101000100000000000110000010000000011001000100000101011100001001000001
00000100000110001000101001100100110011000100100110110010000001000000011101001110000111101101100000010
10001000000000011110000110000101001100100110001000010010100001001101000001010010011001000000000000100
00011001000100000000001000000010010000010010011100110001001000010100011000001101000011000001010011000
00000001111000010110000001010001110000100000000011101100010000000001000001000001101000000010100110100
00000001110100000000100000100010011000000000001000001101010000001100101010000100110110101111101000001
00100110000101100000010110000110001000011001001010110000011100100110000000100001000100000100101000000
01000010001001100000001000001111001000011001010110010000101000000101010100111000001000001100011010000
00000000101000000000101001100100000001100000001100101110000100010100011100000010000100100000001000100
00000100010010100011000001100000010011000000000000110010010000000100101001000000000011000000010100000
10101110000100000000000000101000000001100000000101001000000101000100000001100000011110100001001010000
01010000100000010000000001000100001010100000100010000000010010010010000001001010100000011000001001010
00010000010001000000011011110110110000001000000000010000111010000001001000010000000100001001101000011
11010001000000001001100101100100000110100000010000010100001101100000101000000100000000000000000101110
10010001000011010000000000010000000110001101001001010001000010100100000001101000001000001001100010100
00101101100000000000010011001110100000000100011100001101001001110010000010000011000010000000001011000
01000011000100110000000010000110001000000000100000010010100100000110100001000000000010000100111010001
01100000011100100001100001010000000111111000001000000110000100100100010001000110001010110100001111110
00000010000010000001000000011110111110010101010000000001001010000000100100000100100010010100111100000
10000000000100000101000010101000000010001011000000100011010100000001010000111100000010000000001011111
01000000010000100000110010011010001000010000010000000011000000000001001101000000000000111100010000011
00000100000111000001100000000100010100101000000000010001111000000000000100000000100000000000000110101
01001001001000011001000000001000110000000010110000011100000101101000000000000000000001100001100010000
00000000000000001000001001010011000000011000100100000001001000010000010110000000000000111000100011010
00101000001000011000011010000100100011010000010000110000000101000000010000000000101100101100010000011
00000101100100110110000000001010100000010000000001000010001000011001001000000110000011000010101100011
01101000001100010100010000101000100001000011111110001101000001100000101000000111000000000000011000100
01111110100110000110001001100001000101010100110101001010000001001001100000011011001010101100000011110
01101000000001000011000010000011000000011100111101100000001110000000111000000001000000100100100100000
10011111101011001110000001101000000110000100000010010111000010001101000100100100110001000001101001000
10110110011001010100010010110100110001100000101100100000010001011001110110100100101010001001100100010
01101000000000010010101010001100010101110111000000100000100000100101100000001100000111110000101001101
01100100000000000000000100100011011000010001010010000000000110000100011001000001000011000110000100001
01101010110100100110100010000101011010000000000000010010000110100100010110000000110010111000010000000
01010100101010100000000100000101010010101010000010000011000010011001000100000100100000000000000000110
00010101101000101100000011000001001001111000000010000110010000000010110001000000000011001000010000000
10100001000111111001001001000010100011000000010010100010110000100001000010011011000100100000101000000
11011001000000010000100110101000100000011010011010011000000101100000101010100110000110010000010010100
00110000100010010000110100010000000010000101000001000011000001011100000000000000000000000010000000000
00001000000100111010010100000100101001000001000010000000100000110000001010110010000001000001111000001
00101100001000001000101111111101101100100001000000100001010000010100100001001001100100101010000010010
00011000000010101010100001000011000000000000110100110000000001110000110011110011110111000000100000000
00011000101001010011000110001100001100101000001101111100000000000000001100000000000000000000010000100
00000001000010000000000000100010100011010000010000101000001001000000000101000001000000100000010000011
11011100000100000110010001101001000000100100000010100010100000100000001010010000000000001010000000000
10010001000000010001100010000010101110010100100000001100001010011011100100000011100000000100000010100
00011000011100111101011000100000100100000000000001100000010011001001000000010010100011001001010110000
00001000000100010100000000001001101100000010100000110010110000100000001000010100000001111100110000100
11111110010000010001011001011000111010000101001100101010100010110000000011001000000011001010011010010
00100100011001000101100101010011000010000000010110000000100110001100000010001011001101110000000101001
00001000000101010001110100110000100001000000100100001001010000100010100011000001100000011000110100000
11000000000100100100000100100101110000000100000001010000111000010000000100100000000101010001010100001
00001110010000101100011111011000001000100101010101000100010000000100011101110000000100010000100100110
00100000110000000001000000010001110110110100000011110010101000001100110000011010000000000000100010000
00000010010001100000101101000001000000001010011011000000000000011011000000100010101001100000001000101
01001110100110100010101100111110100000110100111000110001011001000100001000111000100000100001000000000
00000100000000010000100100000100001101000001110000000000001001000000001000000000100000010100000110000
