00001000110100010010001100100001000010000010000100001000100010110001110001000000000001000101100001000
01101010100100110010010000000001100001001000000101001000100100000100100010100000010100010000011000010
00110110010000000001000000010110011000000101110001100100100111000010001000101111010100000110100101000
00000000010000011000111001010000000010001100000101110000000000100110000000001001010010011110010110101
00000000000101000110110100000100000000000110000001010100010111001010000010001000001000100100000001111
01000000000111011000000000110000110010011000000001011000000011010100101000000010000000010011000011010
00100001000101000000011000000000011001010100010010100000101000010010000000000000000000010111100011000
01110000011000000010000000110000010000001011100000010110000100010000000100000110000010000000110000011
00011010010001110001001011110001011000010111000001100000000010110100100110001000001000100001000111100
01011010100011101010011001001011010000101010110000000110000110000000000001101100110000011000001100111
00010000110100000001010100001010001000011000000000101000011010000000110000000110000100001000011011110
00010001010000000111100100111000000101010100000000100001000000001010010000100100101001000000000100101
00100011000110000110100010000011100100100100001010001000100000010100000011000000010011101000000000010
01101010100110000100110100000100010010111110000110101000000110010100000000001101010000010011000100101
00011000100000101010000111001001100000110100101100100100000000110010100010100010000110010000101101010
10000001000000001110000001000000100000010000010000001111100010000000000100001000100100011000010010000
00000111010000010010111000000100000000000000100011100110000100001000000000010110000001101010010001110
00010000000000011000000100001001100000011000000010001110001001001000000000010101000000000000010000001
10010010001100101000011001000010000000000000100000010000010001001000000010110010110001110010000010010
00100000100110000010101110001100001100010110001101000010011111100000000000001000000010101000100000010
00001100000000000010001001100110101111010101001100110110000000000010011000000000001110010010010010000
01000000101000010010010011000000110000000101001010100000010101000100010010000100010000001010000010000
00001000100000010010000000001011001110100001001011110010000010100000110000100011001001101001001101000
10010100000000010010000000000000001100001000000111001011000101011000101010000000000010110001010010100
00000001010100010010110100001000000111101101000110010100000000000001001010000010000000000111100101100
11000000110010101110000110010000001100011100000000000100100000110001001011110010001000000010010100101
00100001001000101000001000100010000000100100101100101000011000100110010010110000101001100110100000010
00010101100010000101010000001000001000000010010100010001000100000000100001000111010000000000001110100
00000000000000000000010000000001101000000000100001100000101000000100001000100000010000000001001100101
00011101101101100011001010011100000000000000000000000110101100100000000000001000001010101100100010100
00000000100000001111110001000011000111001010100011001000001110000100110110100000001010001110010001110
00011001010001000000000100010100000010001110000001010000000000010100001000100000000000000000011110000
10111010000101000001000010010000010010010111001001100010101010010000111000001000000100000001101000000
10001011010110000000110110000000001000010000110000000101100100010001010010001000000001101000100100011
01011101100010110000000010001000001101100111000000010000011110000100100000000011110000100110100000100
00000011000000110000000000011001000111000001110001011001111000100010001100100001010101010100100001001
00111110000010111001001111110000101000101101001011011000000000011000010001100000000000000000100000000
00000000100010011001100000100000001101010101000000000001100011001000100111101101000000001000010000101
00110011000000001010010000010010011100101010100010011101101000010100000000001000101000000010000000101
10010101010000100010000000001010100001110100110111100100110110011000100000000000011000000101001110101
00000000000011001001001000100100000001000110000110000001000010100110000001010000001010101111010000011
00000100100100001100001000010100001010110000101110010100000000010100000010000000000001111111000110010
01000000001110001000000001000101010100110010100101011000100010000011110101111100001000010100110001010
10000101010000100000000011000111001100000110100001010001001110010110011011010011001100100101000000010
01010011101010110000000000111000000011010100000000001110100000100100001000000010001011000100010000110
10000000000011010000000011000101000000010111010100100100001110000001000110100010000000100000010010111
00000000100010110001100000010000101110000000100001100000000100010010000001010000100000110110001000000
10001001010010000010000100111101100001101110011101000010010100100001001001001100010010000011110010010
01001001010010010000010111000001111100100000000100110000001100001100000000100110000000010001000000001
00000000010000100000000010000100000000001001000001001001001100100000011001000111110100110101000000000
01001000000100110111110000001001010000100100001011001101110001000001000100101100010000100100000100000
01010000001000011000000011101010000000101000010111101010001001011001000010100000010000111001001111111
01010000111000010000110000000110000100100100000000000011000000001101001101001111010110010000001000100
01000100000010011100110001010001100000001001010100010011000000000011000111001100110100001010000011101
10000010101011000000011000000100110010000010010011101000000101100110010000100000001100100010000000001
10000001001100000000010000001011100000001110000011110010100011000101000110001110000000000011101000000
10010011101010010100001011100100100011100111000000000000010010010000000001110011000011110111110100010
10000000100110000001100100100010000000000000100010000101000101000011010000000111110001010000000101000
01010001111100101000000011000000000001010100110000101000100100000100100100110100010010000000001000010
01100001100000000000000001110000000001000001000001001000100011010001100100101101100000000000000110100
00101000001010010111000010010010001100110000001100000000000000010001100000101111000010110110011000100
01110100001000000110001001110000000010000000000010000000000110001000010000000000000000011100000101011
00010000000100000000100110000000000000110111001100000000000110100000001001000000000000000000000101000
00110000001000101010001011000000000000000000000000001000000100010101000100000010000001100010000011101
01000101001000000001000000100001000010000101101000010000001000010000100010111100010000000000001011001
00100011110000000000000101010000010001000000101000100000000010011000011001000000100000000000001000000
00000111011000001100000000000001000100010110000100000010100111100000000000001000000101100001000000100
01000100000100111100001100010000001000000100011011001000001000110100001000010000010000100010000000000
00011000000001000100001000010001100010001101010000011000101001000000011010011101001010010000100000001
00001001011000100000000000011010001000110000010010010000000000101010100000000001100101000000000110000
01100100110111110101011000000010011000001001010110100000000000100101110000110100010010100010110000000
10000101100001100000100110000001011100000000000010000000110100100100000001010000000010000001010010000
11101110000010000010000100000110100000000000010000100100010001110100010000100001001101011100100010011
01001011000001001000100100000100110000101100010000000001101000010110000011000010000000000001110011011
11001010000000000000100101001110111010011000101110100110101101100010001100001110000011010010110010100
00000011110100000010101101001110100010010010100000110101000001101101100100010010010010000000000010100
11010010010010101100001100010011010000100100000001110010010000010100101110001011101000010001100100000
00001000001000000000100100000000100000011000000000001100110001010010000100010010000100000010101000001
00001000000000010011011101001000000100110000100100011110000010010000001001000101000101001000101000100
00000010101000111000101101001010000000000000101000001101111000110000000010001001000100001010010100100
00110010100001010000010000110100110000110001011111000111011000100100000010000001001000100010000010010
01000101110010000000101010100010100000010000000100111000110011011011000010110000111010110110101010100
01001111111010110100000100000110000011000001111000010100010010000100010001000010000001100000001010001
10000000001000100111010100000000110111100001000100100010000000010001101100000101111110001101101000000
01000001010000000100100100000011010000000001001100100011101011100100000000001111010101010100010000000
00000001010001101000000010101000001010000011000000100110011001000010000000000101010101100000001000000
01100000010000000001011000000100100000000111000110000001000001000001000101010000001001011001110000010
01100010011000000001100110001100100010001000010111101001110000010000000000000000100000010001000010010
11110110010100001100011000100100001100001000000100000000010100001100001000010011001001010010001001010
01001100001000010001100010100010110000000000000011001100000010010011010000010000100110100001101100000
10001010010011000110001000010110100001011000101000011000000000010000000100000000101000110100111100000
11101000011011100000100000000010100010100000001000001101101010000110000010000000110001001000000111010
00101000000000000101100001010100111100110010110010100100001000010001110000000000010101001001000001100
00010010000001010000011000000000000111010000000000010101100001000000011100001000000100101000001000001
01010000001101001000101010101000100010000001000000000101001001000100011111001100110001010100101001100
11001001001000110000100101010000101000001110110000000000000001010110100111101000000101010000000011100
00000000110100100001100100000110101000110011110110000000000001010010100100011001000010100011010010100
00000100100000111010000010011000011001011000000010001011001110000101000000010110010000100011011110110
10000100000010000011010000000101111001110000100111010011001010000100010001001000000010011001110000000
01001110000011100100100001100001000100000000000001001100001000010000000000000010011100000101010001101
00010011010100100000100100000100001101000000010001100000001001100011010000111000000101000000001000000
