00100000101000000001100010010001000000001111000100000000001001001100110000000110000001111001101001010
00001110000100001000100010001111101000100110000000100111000010101100001101101000011011010000010001001
00010100010100010010000001001000110001010011001110000010101100010100000000100000000001100001000011000
10010010011110010011100000100000000100000011000000101000000010100001000000000001011000100000010010111
00110000000010000000101000001100000111011000100000000001111000010000100000100111110010001000000100000
00100010000011010101101010001001011100000000010110001000001000001001000101011010000010001010001110010
11000100001001011000000101010110110000001011000000011000001000101000010000001001000001010000010100000
01000001010110100001000100001000100000000000010001011010100110000010101010100100000010100010000111000
00000110100011011000000100000110001001100000110011101000001000011100101011100000101001010100000010100
01111001000100000001001100000100000100100101000001000110101000001100010111001001010000000000001000000
01100111100001010001000000100000101110000010001001110001110110000001001010111101010000000001000000001
00001100001001101010111001000011010000000010000101000010000010000000001010100000000000000111010000100
00101010000000001000001010101011101000010000011000000101000000010100000001000110000001001000010000100
10100000000000010011110011000110010000100010010001000100001000110110100100001010010000110000110000000
11001010011000010010010001100000100001100010001011000000101000100000111100001101001000000101110100010
00000001000001100001001101000101000000010000110111011000000101000100000101000000010010100100000000100
00100001000100000100110100100100000101000000001001000010111011100010110000001000000001110100011000011
00101010000010100001101011000000101010100100000010000000100000100100000000100101000000101001000100110
00110000100101000011000100010010000010011000100100010000100000110001100001000000000010001001100011001
00000110000110000000010001100000110011100110100000011010100000101001001001000010000000110101000010000
10001110000100111001101000001010000100010001100010010001100101000100000111100001011100001001000001000
01001001110000010010001100000000000000000100000011100000000000001000001001100010000001100111000001000
00111001010100010010000001000001010100000000010000010001110000110100000000000000010010001100000000011
01000011000010111001000110001101000011010000100101010011000100000010111100110000010001000001001011000
00100100010000100000000000010101001010001001010000000010010011111100101000100100010010000010000000000
00001110101110001001000110010011000001111101000001100000001100001101010000010100000001101000010101101
00110000001010101000101100101101010000100000000111010000011110110011000010100001011001100001111101101
00010100111001000001010000011111011001010000000000000000101100011011010110010011001110000101001110101
01010100001001000101010010000010111010001100110100001000110000010000000110000100000100010000001010001
10001100000100100000000100010000100100100000001000101001100000110000100000011011000000000000101000101
10000110000010000100100000110001000001110001100110010111010010010110000000111000100000000010011011010
00000001000010000000010001100100001010001100000000000000000000011110001000010001100010010000000010110
00000100100010011010010001000001000001100010000000110100111000000000000000000000101100000000000000000
11001001100111000101111110010001111001100010010000000001100000000001000110010001011001000001000000100
10001010000000010000000000000001010001010110100110010000000000010011110101000010000001000001000000100
00100010001101000010100000011000010001101000100100000001110111001101100000000000000000100000001010101
00001011011101000110000001000000001010110010000100010001100100110010000000010001001010110110000000000
01110100000000000100000101011001100110000101010000001000101001000110010110010001000001000000111000110
00000001000010000000010100101001000010000100000101100001011000100010110000000111000001010110100000010
00110010000000101001000101011000101110000110000001010100100001100011011000001000100001000100000101010
00000101000110000000011000100000000000001001001100100000000000110011000010001000010100001100000010000
00001000011011010000000000010000100000000110000001010000010001001010011001001001000000111101001001001
01001000000010100000000010001000000010000000111100000010101000000010100000110000010110000100101000100
00010101000011110000101000100100010000101011011000000001001100000110000111001000000100001000000000000
01100100010001000010110100100111000100010100100100001001000001010110000111001011100000000000101000100
10010010000011110010010000011000000000101001110011000010111010100000100000011100000110001001011000000
00100010101000010000100001001000000011001010000001111011101100011010000110101010001101001000100100000
10001000000010000101010101101011110000110011000011001010000000110010000000010111010010111101001110000
00110100100001111100110011001100000110000100000011000110000100000000100000110011110100001000011000110
01011001010001000001000000001010001000100101010000100100001011001000001111100110100110000000100000011
10000101110011111001001001101110010011011010000001010100001011110000100101001000100001000000100100001
00011111001001001110000000000001100000110100011011000010000000010010111001000100100101010010101000101
00010001000011000011000000110010110100010000001011100001010110101100001110000000000101100101000000100
01101000010000000000001011101100010111001110010000010100000001110100010110000000010100000011100101000
10000000000000001101000010101010011110110000001000000000000010000100000000110100000100000100100001101
00000000000001101000010001100000110001101001100111001010000101000000011000111010000100010010100000001
00100000000001100110100000100100000000001001001010000010011011000101100010001100001001000101101000100
01000010010001000100010000000000101001001001100001010110001001110000000100000000011001000001010010010
00101011001001000010000000101101000101000110100000100001100000011001011000000010001101010000100110100
01000100001000000100010010010010100001011000000011000011110011100011010110000000100011001010000010101
01001000001010010100001001000100000000000000001100000001000100001000010010000011100010100001000011001
10011100000111001000001000110110001100000000000010110000110100000000000110000000010010000000110100100
10000011001110001101000000000110111101011001010001000100000000100010001000000000101100000100000000000
11011001000000100011100110100001001001000001000000101000000001010001101110000000110001010100011011000
10101100101011000010100000010010000010000000100000101001100010100001111000010000000111001001100000000
11001110010101000001100001011100100010100001100000100100100110010000101000011100100000010100000001100
00000000000000000110000000001000011011000010010010000110110101100110000100101101100010110000110100111
10110000000000001011000010000000101000101010000010000000001001011100000001100100000110010111000000001
11100001010010100010011011000101101010000000110001000010010100100101011000100000100000001011000110111
10100010100111100000101101001011001000001001101100000010010101010010101000000011011100100000000111100
00000000000001001011011010100100100010000100000000101000010001010010000010100101101100000110010100000
00100000000101000110000010000011000010101100101000000100000000100100001010111010000101000100000100000
10010010100000000011000100000010110001100100100100000011101100010101010011000101101110111000101000001
11000100000000001110101000111000100000000011000010110100001000001011010100000100110000010000000100000
00001010000001000000110000000111010000001001000000001101010100100011100000001000111001100000000000000
00001001001111010000000100001110111100100000010000010000010000001010000011010100111011000111000100010
11001011100001000000000010100000001101010000011000000001100110010001000000010000000010100000000111001
01000000000100000101110110101001100000100000000000001000000110000000000100100000001010100100100100000
00001000111000000001000010000001001000101111000011010101001000011101000000000000010111100100101000001
11001000100010100111000010000100000101000000001010001000001010011000100101000011010100011001000000111
11110000110010010011001001010000000001100100000110000010000001011010101010000000101000000011010110000
00001000000000000101100000101000001100100010010000001010000000000100010000000000011101000000111001010
00001101010000000000000000100101100000100101100001000011000000000010011100101000001000100010101000100
10001000010000000000101011000100010000010000000000010000000100100001011000000000010001000000000010000
00000100000001100000000000011000010000001010010110001110011100101010001000000000000010000000000110101
01010000000110111000100010110001000101000100010000010000001000010000000010010000000001110101111001100
00010000100000000000110000001001110111000010110110110000110110010010100000000001000100010010000100100
10000000000110000001000000100000000000100001000001000000100100101101101010100010000101010101011011001
01000000000001001100000010000100010010011001000000011010100001101000010000000011011100110100010101000
00001000100100000000100000100010000010001000000001010000000000001011110111000000001100000011011100100
01100000000000100100101100110000010010010100010000100100000001010000010111100010000000110100000000000
10011100100001000001111000011000100101100000010000000001000011000010010100010000000100000010111001011
10100100000000000001100100100000011010001001000100000000001000110100000000100100011101111000101100001
00100000101011000000000000000000000001000010001010011010100100101010001010100000110001010001000000010
00110001000000011101110001010000000110011100000100010101000000101000101100100110000000101010000000010
10000100000100001110001011111000000000001001100000010001111011110010100000111000001000101010000101010
00000010101101100100100110111010001000000100011000000100000000100001000000000001000000000010101111000
10000000010001000000000101000010010001000100000000100001100010000010000010101000100010000100100001001
10000000010000011000001000000001010101011011100100000010010110010101100001000001000000001011010110010
10010000001000001110001000010001100100000010000000000011000001000100000100111010001000000010011000111
00000111010010100100000000000011010000001001000100000000000100001000000000000000011000000100001010010
