01000100010101010001000000000101100100011000110001100100110001111101000010000000000000011110110000110
01010000000001000011000100011000000000000100011110001100000000110000100100000101000000000100001010000
01000110000000011011010100000010000000000000000100010011010000010111001010100010110110011100100000000
10111000110100100001100000000011100001010001000101100101100111110001110011011100001000010110101000001
00000010100100000000011100000000000101010101010001100000000011001000011000010000000000101110011110000
10110000110110011001000000001000010010000000101000110110000000001110000000101001100101010000100000111
10100001000011100101010101000000010011101010011000100000011010100110000101000111000100000010101111000
10100100000101100000010000000011000000000000000000000000100110001000010000001000000001010000101010001
00111010010001001010100110110001100011100101000000010101001001000000000010010100001001010000110011100
00100100001000001100100100000111100011000010010111010000101101010101101001000100000100001000001000000
10100010001101000000010000010110100001000000000000000001010000000110010000001111000100000001110101000
10011100010110001001100000010000000100001100000000000000000000011110000000011001010001010100100010110
00000001010000010000001110000101000010111011001000100000100110010010011000000010110110011010001010111
11010000110010100010000011010010001000001001011000000001000001000110110010010010110000000101000001001
00000000010101001010001100101000011101100000000000000100011110001101000000000111000000011011000000000
01000100010000001011000110000010001000000000000000001001101111000000000000000010000000000101111011110
00100000100000100100001000011100110000110100010010001101001001100010100000000100001000111001000000010
00011100000100001011100011011000101100100100011110001000001000001010101101010000100000000110010110111
00100000000000000000000100000100001000100101000000010100110001111001100100001000001100110111000011101
10011000010000010010010000010000000110011011001010100001100100010001001110101000000001010001110001010
00100000010010111000000110010010011000001000000110000010001010001001100010000010100000010000100010110
00100000011000000010000110010110000111101010000011001000111111100111001100100000001100000001100001000
00000000000000010000000010111110100101010001110010000010101100001010001000111000000001011000101010010
00101110000000010111001001001110101000000101101010010001110100001000110100000101000011101000000000000
01001000010100111000001000000000000110000000000000010000001000101000000101010010000100110111111101000
11000000011010010000100011011010000011010001011000110100000001010000101000000100001100000010000010100
00001000101000110000100000000000001000001000011000100010100001000000100010001100000101101100010100001
10100000101010010000110000010010101101000110001011000101001000001000110100100111000101100100000000000
00010000000011100000010100101100000100101100010010011101001000100100010000001010001000010000000110000
00010000100011111011001001000000011000010010001001001010101101110001000110000110010010010000111100010
00010000110000101111010010000000000000011010101010000011011010000000001001001010100010000110000110100
00010001101010010011000101011010010000010110111011101010010011010001000000000010001011001010000110000
00011000000100000100110110000011001001100000000001010010010110000111111010000011100001011000110000010
10110001110010100001000100100001000100110100010000000000100000000100010100010100000000010010001001000
00000000101000010000100111010110100010011001011000001001100000000100000010001010000010011010010010000
11000110000010010111010001000000110111000100010110100000111001010101110000100010010001010101000001000
11100000000100001010100001000001110100100000110000000001001100100010110000000000000001001100000000101
11000000000100010111000010000000100100100100000100001111101000000011011110000101110110000011101010111
10110000100000110000010000010011001000111000100000000000000010010100000100110000010011110001010000110
10100011110000010000000010000000011000000001000010001011001101000010100100000000100101000010100100000
10010101000110000101000010000000001000000000001001000100001100000010100001100000000000001001000010001
01100100001111001001000100000000001000010000100010100100101000010010000000000000001100101000001001000
00010100100010001001111001110000000110110001101101100000011000000010001000000010000000101010000010100
10000010100010010000000001000000000001110001001000010010000011000011010101000111100100000010011001000
00010000100011100100100000001011100001101010001111001000010000010000001000000100000001001000000001011
11001000010000000110001010010000000110010111100100100001111001000000000100000100000000000000000010000
00000000001000010001101000110011001000000100110000000000010000000100000101101000000000001101100011000
00000101000011000010010010110010000100111001110000000001100001011010000000000001000010111010000010110
01010011001000100000010100111000100111010100000101100111000111010101101010110000000010001011100010000
11000111101010000000001101000111100010100100001011100100000111110001000000010100011100000000001001000
01101010100001000000100101010000100010000001010111111001000100000001011001100010001011010000101110010
00011001000001001101101101000100000011000100010010100001001000010111010010000100000110000011111001000
10001000000010111010001010110110000100000110000000001011011001101100100000100100000010011101000001101
11010000000010001011001000101001000100000001000000010110000000101000111001100000100010000101100000100
00000011010100010100001100000000111000001100100100000000000010010001000000000000110010010100100000001
00101010000011110001000001000111000000100001000110000010000000001110000100011001101000000000001010011
00010010010111010000001000110100001101101010001100000100000010000000100101010100101001110010010000011
00101100100001100111010111010000100000110101110010000000001101110110000110001000110010100011010000011
10100010000100001101000110101011100010000100100010100011001000001001001000000110001111011111000110100
00101001010001010000000100100111001100010010110010000100000010000110010101000100010110111010110000011
00000101111111000000011111011000011000011010000001001010000000010001000000100110111000100110100001001
11000100000011111000010000101100011000100010011111000010010110010010000000000101100000100110001000100
00100000010010000001000000111000101000001010000100000100010000001000100000010000010101000101001100100
00110001000000110010010010000100001100110001000000010110010000100100000110000110101100000100011001100
00000110000011001000110010100010010110101000000001000001000110111001100100010000100000100110110010110
10000111110001000000000101001000001001010000010110000001101000101010000001001100110010110001011000000
01010110011100100001000000000101010011000000011110100000010000110000100000000111001100000011010101100
10010100010101000000111100010001110000010000000000000010010010001100001000010010000000110111101100000
00100011100100010000100100001010000000000000000100000000111100100000000011000010000001100011010011110
01111001001111100010000101001101000010101101000100001100000101011010000010110000000100000000000110011
00010000100100000101010010001010101001111100010000100000000010001100101001100100000010101010011101110
01000110010011000010000100001111000000100000110100110010100000001100100001110001110100011110000110100
00001100100000000001000110100000000001110011001000100001100001001111000010100110010010000000000001000
00001001111001010001000001001100000000010001000001000100000000010000101010000100110100100100000000001
00010000001010010110001000000100000100010000000001001000010001000000000110100100001100011010010000101
00000000101011101000100000000000001011110101100000000010000110100000011111001000001000110101010000000
00100100001001010001001000010000011000100110111101011000001000100001001100101000001010000101001010000
10010111110001000110000110100111000110100001001000001000000000010101000010001001010000110001000000000
00000101001101010110000000100011000000000100001000100110110000101000100010000100010100100011000000110
00010001010000110000001001010010011000100000000101111101011000000101110000011010101001001001110000000
01100010101100000110111100100010000000011010111000000101001101011000110101010100110010000001000000010
01000011010001100100000000011011100010001001010000010000000111011001010000010000110010000101000100100
00000001100000000011000010010100001010100100000100111010011100000001000110100111000100000010000000110
00000110010001111010000010000010000000011100001110101111000000010100100110000001001000001010000100010
00011010011010000000101001000000110110000100001010001001001001000010000100000001000110000111000000000
00000000110001100001100010010000010100001000010000000011110010110000001000000000000100100100000110110
00010010010000000000100000101010100001100010100100001011010010000111000000101100100001010000110101010
01001101000101011000010000100011000000000000110100011010101000100111000001000100100011001000000010011
10011110110011001000000000101010000001001101110001001101100000101001001100011010110110101001000101011
01111001000001010100001010010000000100000000000100001010100110100010001101000000001011000001000000110
00000110100000100001010101001111000010101010000011000100000000000000010100010000100000010100000001011
01000000011000000100101000000000100001000011100101000000100010110010000010010100010101010000000011000
00101100101000100100001100110001010001000000100011000001001000110011000000000001100010000001000100001
00011011000100100011001000000101001100000001100000100001010001000000011101010000000000000000011100001
01000010100101000011100100110000100100010110000100001000000000110101000101010010000110011000100000010
00010011001000101000100000000000010101100010100100000100000000000000000010000110100001110100000101000
00100000000001001001100000011000010111011011001001000001000110001000000011001001110000000011010101100
10011100000100100100110000010001101100010010000100000001000011010010010000110010001100000001000000000
11100100000000101001011111100000100110100000000101001010000110100000000001000101000011100000000100101
01100100000100100001100000010101000111101110010001001110000000110000011100110111000000000000110000000
11000100100100100000000000111000100010100001010001111001100001000110000000000100100000000001100010010
