00000100001000000000011000110100001100000011000001000000010100000011011000000101101000000000100101100
11000001010010101010000000011001100000100001000000011001010010001100000110110001010000011011001101110
11010000100001000000010110010001010010110001000011010111011000011011001011101100001001001011111010000
01000001001010001100001000000010001010110111000111001001100110000010110010010001100001011000000000010
11010001000010010011111000010000001100001000011000100101000010010001011001000001010010010000010011001
01010011100001111011010101000110001101010000101011000011100010010010001100010000100000001100100110000
10000110001011101000100100111101000001000010001000000010100000000101100100000000110000100000001000001
00001000001010010000101010011000000000000111100000001000100101101100000100110000001010001110000000000
01110000001000000000011000011000011100000010000010000110000000000010011110000000010101000000011000010
00000000010000000001010000000100101001111110000100000010000000100111101000101010100010010100001010000
00100100011101000101010010001010101010101111000010110100100001111100010000000001100010010000110010000
10111001101000000110010011000100010001100110001000001110000000001100000001100011010100000000010110000
00000001101101001100001001000010000101011100010100000101111000010011010110100100010010010000001001011
01100000000100000100001100010001000001100110110110010001001100101010000100010001011110100000100101111
00100000101110100111000100000000000010001010000010000000000000000001110011001000010100010000011000111
10001001000000101011111001000010100100100000001100000000110000000001011000010100100000000000001000000
10111001000001100100000100101000100001011110100000000010000100000000100010000010000000000000000010010
00100110100000000000101000001000001011110001011000010000001000001010000011001100100100000010010000000
00000000100010000000000001010000100101010000010001011100010001001001100101110011001000000010001010001
01010001000011010010101000000001101000001010010000100001010101100000011000001101000100100010001001000
00101001100000010000011001000001001110100001100110001100011000110010110100000000000010000100001110000
00000000000011000011010000000011101000100101000100010010000000001100110001100100000101000010000000101
10100110000110111001000100100000000100000011010100111000010001100001111000000101100100011100100010100
11000101000000101000010100000001100011001010100001001110000110010000110000111010100000100100001100100
00011000011000010111001100001110010011100010100110000010010001100000001100100000001000010101010010000
01000101100101000100001101101101010000010000000100011010001000000101101100000010000000000000100110000
10000000000011010000100001000100101001010010100001000000100001000000001010101100010000100000000001000
11110000001001000000001001000000100010100100001100010010001010000000001110001110100000101010011000000
10001011010010000000000000001000100010000101010010010011000100000001110100000000000001100000100000101
10000000010000000111000010000010100100001000001111101101100000000000000001010010010101101000110001001
01000010000001000010000110000000000000011010010001000000000110100010001100100010000000010000000000010
10100111000011010100100000001000111001000010000100000001000000000001001000000010110001000011000000101
01001100001100000100010010100010001010111101000001100000001101000010001000001010000110000000110010010
00000100100011000010000000000000000110000000011101000010010011001010100000000100000011001000000100011
00001111010010100110100100100000000000011011001110010010010001010010000100001001001100110000101100000
00011000100011100000000001010000011000010001101001000010001000011010010100000000010110100000000110110
00000000000001100100001100011001101110010000010000101101000010001010011010010100000011011111010010110
00000000000010100011000110110001000001000100100010000110000100100100101001000000100100101000001000100
00000000001010000100000101010000001010101000000010100011010000010011100101001110100100100001000011100
00000010000000000101001100000000101001100100110000000000010000010000101001111101110000100000000000110
00101100100010111000100001110000001010010000001001000100100011001010000010001001001001011001100000000
00000100000001010001000000001000000001011100000001001000100000010001000111100000000011101000010100001
01001000000001000010000001001101000001001110101010000000000000110010010011001000001001010011000010100
01000000100000000010010000101001000100100010100001000000001000000000000001000000110000001011101000001
00100000010011001010000000010010110001100010000100000101100000101000001001000000110000000000011100000
10011010100000000001000001100101001010010001000000101000000000110000110000000000100100011100010001100
10101100000110100000010001001000000110000000001000000010000110000000000100100000010010101111100010000
10000010001011100010000011000100000010010010011000001100000000010000000001000001010000000100100010000
00010000100000000010010011111001001000001110100000000100100010000010011011011100100010000010000100101
10100101011000111110010001110101000000100101011010000010101010000000000100010100101000000000101100110
00010000001100110100001001100000010000100000001001101000000010010000101000100000000000000000010000001
01101001110000011101000000000001001011001010000000010000011010110101000001111000000000010000110101001
10011100011001000000110100000100010001111000011000000000001000000110001100101000000011000111011010100
10000001000000011000011101101100010000101000000000010000100100010100101001010000010001000010000011000
01100100100010000100011011001011010000010000001010000000111000000001101100000000010000101111100000011
10001001100011011111000000000100000011000001101010010000010001100101010100000000000001001101001111001
00100000011111001000010000100000000100010010000000100011100000100110001110000100010100010110100110100
00000000010101011000100101000101110110001110000010001100000100000000000000000000100000001001000101001
01000000000100001000001000000000000000100001000111101010100001001000000100000000000100000100000100011
00101000000000010000000000000001010000001110010000011010010010001000011000000110001010001100100000001
00000000000000111100001000010000000010010001010011110010000100110100001010100001000110101001000000111
00001110000100010000001010001010101011000110000010001000111000000010000000100001110000110101100000000
00000000011010000100000000010011101000110010000010110010001000000010101110011000101100000100100000100
01000100100000011011000000000101000000111100010100000100110000000000000101001000100000010000110000000
10001101000000101000100001000111000110001010110001100010000100000101000000100100010000100000001000001
10110101000000010011111000001110011001110110010011111001000100101110001010000000000001001011000000100
00000000100000001000011000101100101100001100000101000011000100001010001000101110110100010000001010000
00100010000000010000010110010100111000010001001010100001000110100000000100111001010100101001001000000
10000101000001011010000000010101010000100001010100000111101001000000000100110000100001000100000010100
10011000010001000100010001100101111101010010000100101100101010001001001110100010110000110100111001100
00001001100000000000010111000001010001100001010000001001101001000100100000001000000101100100001000100
01001000001010000100111100001000000000000100100100000000100011001001000110000000001100000000100101010
10110111111111000001011010010101000100101000000000000000001001100100011101101011110010010010100111000
10010011110001100111000001000000000001100101100000011000000101011000000001111011000011000001110001000
00000000100001000000000001010000110010100000010010110100000101000010100001110011000101000100000000000
01011000000000000010011010001010100101000001010010000001100000000000000100011101010000000000000001000
10000001000001010000100000010101000101001111011000101000100011001010000001000110000100001100100101000
00101000100010011000101011010001001110001000010000000000100100000110111010111000010000100010000101001
01000010101001000001000101000101000000011011001010001000100100000110000100010000010110000100001100010
00010100000100010010010001101010000101000000010011001101000001000001100011000001100000101000001000111
11000000110010010001000011000000000000100111001010100001001000000010001000100000010100111000010110011
11000001110110100010011000011100110000000000100100110011001000010000110000000001000010001010000000000
00000010101100100000001000010111000001000000101110010110110000001100010000010111010011000100000010010
01000001001001010000000001000010010001010100000010000000000000000110100110100010000000000001000000100
10000001001010000100011100100100000000000010001000011001110000011100010001000010100000000110000000010
00000100010001100010000011011000011000001010010101010000110001011101001100101101100101000100000100010
01000000010011010010100101000100010011100010001010000000101001001000100000010000000001100000100001000
00101000010000110010100000100001010100000000110111100100000111000010010010010000111011100001000000000
10100000100010110101110101001000011100000000010000100010001001000000001110010010001010000100101011000
01011000001000001110111000000101000110000000000010100010000000000000000100001010110100101100000000000
00010000001110101100010101010010000001000010000011000001000100011001011001110000000001100011111100001
10001110011000100100000100101000001000000010000000001110100100001000101010010010001100000010111000000
01000100011101000110000001011101010110101100101000101000110001000000000000100100001000101010000010101
01100011010011100010000000110000000000100001000010011000000000110100010000100000011010101000000100110
00010010010100100100000000000010001111000000000100111001010000111000101000100001000000000001000000011
10110000010000100110000001011001100000100010000000000110011000011100000000111000000000101100000101000
00001100001000000000000000000101000010001101010100000000000010010011000100001000100010000001100101000
00011100001000010100000010000000010000111100010000000000001000000100010010000010011001011100100010000
01100101011000001101110000100000000010100010000011001111000101001000110001000000010001001000001011101
11000000100001000010010001000000011100010010001000000001000000001101100110010110000110000110001001110
00101110010010010010000010000000000000001001100110001111101000101010010000100000001000000100001000000
