00100000001011001110100100001000101111001011000110010000010001001000000100000000100000101000000010110
01000010001001010010001111100101110100100110000100100010010010001011000010010000000000000001101010100
00000000001101001110001110111000010011100111011100000001001101001000001100010000100010001000000101010
00000110000000001100100000001101000000000101100100010000110110000000011000111100011000000000011011001
10111000100000000100100010101110000000000011110010000100000100000011010001000011100110000010001100100
11000100100000000000000000101001100010101101001101111011010000100100010011011101000001001000000100110
00100111000100101000010101000000011100001001101001000111010111100101100001010010000010000101100100001
00100000111000000000100000010100000101001111000100000101011110000001000110011100001000000100011011100
00000001010100001001001000000001000101000010010000000111010000001001000000000011000011000100000000000
00001000010000010010011000000010000111000001000000011000010100000110101010111011000010101010110000000
00000010000101101001100000001011100101100010011001110000000000000100000000100001001111000010100010110
10000111101010101000100000010100000000010000000000010001000011000010001011001011110000001010000000010
00100100010001000100000001000010111000000110000001001000000101000000101000000100001000000000000000100
11100000000100000001000010011000000000100001100001100100010001000101110010110111010000010000100010000
10010000001001010010000010100001001000010010101100000000010000100100100011001100011101110100000000000
00001001100011100100010010101001110000110000011110100111000000110100001011010010100101000100100101100
00010011110100100010001101000001000100001010010100000100100010001001010000110000000101110001000000000
00110010001001001000100001000000010000000101010000000010000000000011000010000001010001100001000100100
00010001000010100000001001010010100000010001000000000000000011100000000000000111000000100011000111000
01100010000100000010101000100000010100100000101010011000000000000010001100100010001101110101010000001
10000000000100000000001010000000000000001001010100001000000000100100010110011000000100010010000000000
01110000100000000110101000001100011100101011101000100101000010110001000100001000100000000011001100100
00000110000110000000100010110000000010000100000000011000000001010110101010101011100010000000000011101
01000011000000100111000000100001000001000100001000111000100100000100000000110000000101010000011100000
01001000000001100000001000011000000100110000100000000000000110100110000001000000100010000101110010001
00100100000101101000001000000000010000101000000000010011000011001110000000001000101010000101001100001
10010111100100100000101100101000000000000001100000001001001000000010000010100000100100001101010000000
00001011011001100100100110101010000100000110010000101010010101000000000000000011000011100100000101001
00000110010000001001000101110010000010000001000000011110010010000010010000110000011000000010000101101
10001100101100100000101010001000110000010010001000001000000011000001011000001001111110101100100101011
10100100000011001010010001010100001011100010000001000000000000001000101100001001001001000000100000000
01000010000010011011111000010111001000010010110011010000000000100000101001111000100001011100001000100
00010100001111000111010001010101000100011000111000000110000100000001000000000111101001000010101001100
00010010010110111101001001000001000011110011010011001000010001100000001000000000000000000001001010011
01110000100000001100001010000111000100000000000000011101000000010010001000001000100101011111010111010
01101000000001100000101000110011100010100000010001000100000000010000010000000000000000000000101101000
10000101010110000100011100000100001101100000101001100100000011001000100100101001000100101000000000101
00010000000000001010000000000110001111000000001010011000000100000000100000101011000000101000110010100
00100000010100101100010100001001011001011010001001011100100100100000001100000010000000100101111000001
01011011000000000000110011000100000000000000000101101111011100000101111000011011001100000100000000000
00000101010011001000000100010101000110111000001001000001101010101001001101010010000011001010100011100
00110000010000000001110100110110000010010001001000111010000000100110001100000001000000001000000110000
00000010000000110000000000001010111101001000101000000111001010010000000010100011010001000110000000011
00001010100101010010110000111000110000100001000000000010010000011001100000010100000100001100000010010
10100001100010000001100110000001101000101010001000011000100000101101101010110110100100011000010000011
01000000001000000100101010000001100100110010100101000000000010000100111100010011011010110010001101010
10110000100110010011101101110010000001000001100101000110001100101000100010000011011001010000000000000
00100000001000001000000000000101011000011011110110000011000000000000010000101100010100010000000010001
00000001000111000000100010001010100000100001000001010000100010010110001100001000010000000101011001100
01110001111000100001010010011000001000110010000010000000000000000001101001011000001000000111001100101
10011001000000100000000000010000100000100110011011001100000000100100101000011100110100001110000100000
01000001010000000010010001000101000100001010010000001001100110000101000001110000011010110100010011100
10001000100001110000010000000001000100100000011010111001100010000010011101010101001100000100000010100
10111001101001101000101000000010011000001100100000010010100111010001011000000001011100100000000010110
01000010101010000000010010110000100011100001000000101001100101000000001011010010110000010010000000001
00010110110100000100000000011100100010001011001000000000000011001111000100100000010100000010110000000
10110000000010101000010000100000000100000000101100000010111100010000010100110110001100001000000111001
00100101000000010001011101000010100000111000000000001001001000000110000011001001010100001001001000000
00001000000001100100000001001001000111011010101101000011011111000001100010000010000001000101000000001
00000011000010010000011110001110000010100010000010110100000100000010000000000001100001001000000001000
10110001000000101010001000010101010010010010010010000100100000001110000000000101100100000000010001010
00000001000000010000000001001001000011001010110100100000110000000010010011100001000000101101110001001
01001000011001111000010000111101000111000101001110010010100000000000100000100001010100000010100010010
00000100000000101000000000011000000010001000001010100000011110001010100100000001010001000110100110101
01001001001000010000001001000101000000010010010000100010100010000110000010110110000000010000000000100
00000000000010000100100000100100001000000111110110101001000000000010010100001100000000010000101110110
00010110000100001000100001001000001000100100011110100001000000000000000110010011001100000101010000001
01100000000000110100100000000000000000100000101000000100001001101000001100000010000001010000001010110
00000000010010001001111010010010101000001000011001011100000000001011010000000100110101001111100000010
00001001100000000010001000001000101000010110001010101000000101100000000010000001010000011000000000100
00011001000101110000000111000100000011111001001110010010000110000000001000001000001000000000101100011
11010010000110000000000000000101000000100010010010000000111000100101010000101110000000110000000011010
11110100000000001100101101011000000011101000100111100110000011001111100100111100001001001100010010100
10101000000001000000001100001000000010000100000010100000000000000001000000010010010100000011011010010
10001001000111100001100001100000011010100011000001101010010001110000000011000000100001101111001000001
00111011000001000000010100010000010010000001100010010000010000100110000100100000110000001000001010111
00000011010101000100001001000001100000010001000001001010111010111000010010100001111000010000000100011
10001101001000100000000000010001001000001000000010000000001100001000000000101000000101010000000010111
00000010010000011000110100100010000100010000101010110000100000010011111110000111001101100110001100000
00010001010001100110100001111000011000001010111010010000000000000100010101111000000010000010001000100
00110101000011000011101001000000010001001100001010000111000000000001110100011010000111000001000100000
00011001100110111000010000000001010000000101000011010010100000100000000001000100100010100010010001001
00100010010000000000101000011001000000010000000000000000000010001011101010101000000010000100001011111
01000000100011010001001000100100000000010001100100001000100000000010000011000100010010110000010010000
10000010000011000100010000011101011001110010010111000100000001000001010000010000000001110100101001001
01000000001001000011000000001110000001000000010110100010110100100011010010000100010111010001100000101
00101001101010000010001001001100010000010100000010011110011000001001001000001010011110000000100011110
01000000011111000101001001110000010001110100100100100100000000100000010101100010010000000000100000000
01010000011100000100011000100001010001000001010000000000000001001000100010001110000100000001100000001
00010011010001000000101101110010111000001000010100000100000000011000010100011101100001001001001110000
10001101000000000000000011101110100010111000000110001010100110010001100000000001000001000011000101000
00001000100001011100100001000000010000000000011000100000101110000010001101001000100000000000100010010
10100000000110000000010000000000100011100101001110100000001001101100000000000111111001011100010101101
00000100110000010001000010010011000010011010101001000001001001000010010010110010100000000000000011010
00001010101101000011001001000001010100000101011000010010000000000001000000010000000000100010001000100
00000000100000000110010000000000000001110100011000000110000100001010000110000101000011100000000001001
00010110000011001111000100000000000010001000000001010000000000001000000000010010111010000101001010011
00000100001001001000000011000101100001000001010000111010100110001010001000110000000000100000000000101
00101001000000001011000000000101101100001101000100000001111001001101001110100000110000100110101110100
01100000010000000001000110100000000000100000011000101110100100001100100101000010000100001010100100010
10000000010011101100010100010000001010110000000100000000000100001000001101000010111100011000000000000
