00001001000110100110100001001000110000000001010010000001010000111000000001000011000000110000100110100
00000101010100000001101101000010100000001000000100110100000100011000100000000000000100100100001101111
00010100111010101101101100010000000000100000000110000011000001001010101100110011010100011001010000010
10010100001000001111001001101111011000010000001000010110000110110011000100100100000000110100011010001
11110110100100000000101000010001000100010000011000110000101100001000110010000000000110000001000000001
10110100001000010100100110000000000010010110100000111000101001010001000001000010000000000100100011000
01110010010011100100000000101100010010010001001001010001001010000011000100011000001010001010100001011
10000111000001000000000001001011000101100110000100010001000100000010011101000000010010101100010010010
00110100100001010100001000010000010101011110001001011000100000010110011000000000001000100000111100001
00010000101010001000001101001001000010010100011111001100110000110000001010000001110000100001001001010
11100000000100000000010000110001000010100110011001001111110010101000001011001011001000010011100100000
10000100000000011010000101101000010010101000001010100000000000010010111000000000001001001011000000100
00001000001111000000001111100101000000000000001000110010000000000101111110000010001001010010000100010
00100000100000010000001001010010000001000000000101101110001101010010001001000011101000000000000001010
00010100011000001000010000110100000000010000100000010000000010000101000000000001000110100100000011001
01010010000100000001001100000010000000000100000001010000100000100101111000000001010000010000001101100
10001101111100000011000000010010010000000001001010111001000000000000010010001000000000000000001011000
00110010000100001110000011001011101000111010000100101001101000010010100010100100001010000100000011110
01000011100001100000001010000010010110000010000001100100000000010001001001111100000000001000101000000
10100110000000111001000001001110001010001100000101000000100000101010100100111000000000000001001010001
11101010010110111100100000000110011110100110000010111001001101000001101010100001000000100100000001010
00010010000001000100110100000011000001100000000010000010010000101000110010100000000101111011000000000
10000000000000000000000110100001010000010110000000110100010000101100100110100001010000000000010011100
01010100100000000110000001000000000100100000101010101000001010011110101010110011000011000110010101010
10011100110000000000010100001100010000000010001011000001000101011000000100010000100001000001001001000
10011000000000001000000010110001001000000110000000010101000001000100100101011000000001100000010011000
10101100101000000000000101100011000010010010010010100000000000001000010000001000000111001000110000100
00000000000010101010001010000100001010000101000001010000110001010110001010110101000000000101100000000
01101000000001001000001000100110101010010010100000010000100000010001110000100000101001110001110111001
10000000100100000000000000101000001010010001000100001000001001000010011010000111100000000001100000100
01100001100000000000000000011100100011000010001000100011011011100101101000000000011100110000101100000
00111000010010001011001000001000110110101000000000010000100100001011110001000101000000111100001001111
00010110010000000000101100010000100100000000000010010101010011110000010001010001000110001000010001111
01001000100010101110000001100000010100010100001101011001001000100000010010011010000010000000100010000
11100100010000001011100011110000110001100000101111000100000000000011010000010000010100001001000100000
01111101000000000110000000001110100000100001000000100101000001001011100010101000000000000010010100010
00010000001110000001101100000010100000010000100101000010000101000000000001100001000000110000100000000
10000000000101000000000100000000100100101010010100011011010100010101000010101011000001100000101001100
11000100100000000000100010000010100000011100100010101010011100010010001100010000001010100000101100000
10011000100110001001000100000011010010011100000001110100000001000010000000010010100100101000000000101
01001001000000101000101010001011010000000110000100000000100011001101011000100001000000000000000101000
00001101110100001001111100100100111000001001100000000000001000000100001010000000000011100100010110100
00001001000000100010101110001000000000101001000000010010001100000000001100101100100010000010000100010
00000110011100100110000001000000001101000100000100001011110011010001110001100001000011010001000110001
10001100011001000100000110001100100011000100100011010000001000100000100010100000000000010011100000000
00110100100001000100010010000000010100000010011000100000010011001000001010010000010011000100001000000
00000000100010010100000010000101011001000010101001000110100011000000000000100000001100000101011110000
10111100101100100010100110001000100000001001010001010010101000000000001011100000110000010000011110110
00100111010001010000100010101000000001000110001000000100100000110001000100000011010000101000110000000
01100110010101101010000010100000000101001100000000001100000000000101110100001010001001101000000001010
01111110001001011000000101010000011100000010000010100101100011100000011011100110001000011000000001100
00000000111000100011011110101100000001011010010000011111001100110010110000011101000100000000110110011
11100100000101000010011000000101110100011100000100001000100001000000010000010100000100011001000010001
01100101000100000001001010010000001000010100100000011101100100010000001000101000000000000000001001110
01100001010110000011010100100001000000000000001101111000000001011011011010100000100000010000011100000
01011000000001000000110100000000000100000000100101010111000100110100001001011110011000011001100000100
01100100000101010000011011001000010110001001001110111000001010000001010000000010000000111001101011100
10000111000000010010010000000000010000010101000000010110000011010010100100100000110100100000100000100
00000100110110000001001110001101100001000110000111100000100010100010000000001111001101110000010100000
00000000000010100011010000110000101100010000100001000011111000000000100010000001001110101010000010001
00010100000100010110000000000010001001100000100111000000101000100000000001010100001010000000001100000
10100000101101001111110100101000000001001000101001000011010011010000000000000001100100001001000000110
00110001010000000000011000100000000001010000000000110010011110100000111100001000111000010011100010001
00010110000011110100101001010000001100001000001010001001111100010110011110000000011000101110010011010
00100010010010100110011011000000000100000001000000101010000011100010000101000010001001000010111010000
00011001000000000000010100000000001100011010101000011001011001000011000101110101110000000100110001001
00000101101101001000100100000000001001000001100001000000010001000001100010001011100010000010110011100
01110001110011100001001000110000101001100100010110001000000001000111011101100000000001101101010010001
00100001010010101010000001101000011000010011100110101101101001001101011000000011110000001010111101000
01101000010000011000100000000000000011000000000010000110010010001001100001000100000100100000000000000
00001101000000010000001001011010010001001010000101101000000000010000111010000000110010100011000010001
00001010010000010011001100000110111000100101000100000000000000000010001000000100010000100010000000110
00000000000000000011000110110100010001010010001011010000000000100000000101010001000100000100001000101
00101000000100000100000000110110011101011110001001110010100001110101100001100000100010000000100110101
01000100001000000001001101001000100001000011010001000000000000000001000000000000000001010101001000001
00100000100100000000100000110100000000100011100011110000000000010101000001010000011010000000100101000
10000110111001000000010000001101000000001011000000001001000010000100001001011100001101000000011000010
00000000100101110010001000000110000101001000010101000011000100010000100110000000100000000100010010000
11010010000101000000100000000110100100000001000100101110010110101100011001100010110000100100001010000
01001000101001011000011000100000011010001000000001110000000111100001100000001011110000101000001000001
00010000010111100100010000000000100100011110011110101111010000101100101000001100001000000110000101100
10000000011100001110100010000000100100000001001100000010010001010010110010110010000100001000100001000
00100001000001000111000100110001110000001011110100000000000000001000000001000101000100100010110011001
00000001011001011000001011100000101000101100000100000001100110000000110101000001100011000000000000000
01000101100100000000000000010100010100000100000000000001001001110011001000010010001000000000011000101
00000010000000110001100000000000010010000111000101000000000001000000001110100010000000100000011100001
00100001100011100000010010000011001100000101111100000011100110000000000001001000010000011000010000011
00010010101000000001001000100111100010010101011001000010000100100010100000000100000000000000010110001
01000001000000001100000111111101011100000000000000000011001001010100100100000100101001000010000010001
00110000000011000000001000010010111011010001010100000001000101001000000000000010111010000100000001110
00100010000001000010100100001000101100000000000001011011001000001100000001111000111000000010100011100
00100000000001001000000010000010000000000001000010000000101100011001001101100010010100011000000101000
10010101000000010101001100100001011010100101111000011000000111010100101001000010100000100000100101001
11000100001010111101100000010000001010011000000001000010000000110001000001001000010000001110000000101
00010100110000100000101110001010011001011110000010010100000011110111010011001100100000000101000001010
01000010000010010100011000110010000110101010001000110000110100101101000001010100011011101111100011001
10100010011000101010010000001000010110000010000010110011010000000010000111100100001000100110000100000
10000110000010010011100000100111111000011101000000100001000001001100010001101010101011001100000001110
00001000101000011110010111000010000000001100001011001000000000000011011100010100000010001100000010000
00000001000010110100001001000001011001101100001010011100001010101101010000101010001000011000101010010
00000010010101001010110001000010110001000001100000000010001000001010000000000100000000100001101100010
