00101001010110000000000000101000100000100100100000001001110001001001010100001110000110000100010101010
00100001000000000010011010000001010101010000110000000100000100000001100001111011000001010110101000000
01011000010000111011001010100011000101000001000111000001100010011101010000110110010110001010001010010
00100110100101001001000010001000001010001010001100000001010010011100010000000010000000010000100010110
00000100100000001100110100000000101101000010000001010100000011110011000000010001100111100000001011000
00001000000010111010000001000100101001110100010000010001101110010010000001000000000010001001010100010
01100000010001101001000001000000100100011100110001110001110010000001100100100001001000100110000001110
10010101100000000100011100011000001001110001000001011000100000100000100010010000000110100000100000001
01010111101100110111111100000100000000011100000001110100110100010100000000100011100000000011001011101
00000000101101000000000000010001001011000101000011000100010010000000100100100010000001110000100010010
11001000101001000101000001111000000100001001010010110010100001011000000010000110001000100010000000010
10100001000001110000001000010001100000000100001000000001001010100010000010000001000000001000000111011
01001010000100000011100100000110011000000100000000010001101001000000010000000110001100110100001010000
00101000101001011001000101111000010100000000000001000000110101001000101000101000110000110100001100000
00000111000001000001010010000000000111100000111000100101001110010000101001100010000000010001100100000
10010100000001000000000011101001000001010001000000100001000100010100000000110010011000000000011011100
00100011000010011100000000100000001000010100101001000110010000010010101000001001001010010001010100010
10110000010001110000010000000100000010010010011001001000000010000101010100100010001000011100101010000
11000010001110000000010001001011001011010000010000001010000000000000001000000110000000001010100000010
00100000000100010001100001101010000100000101001011000010000100001100000111000001000000011000000000010
00001001010011011001001000001101001000100000000001010100000010001000000010000100011000000000011100010
00001000000000011011000000000001001000011100001001100100000000000010100000000000100000001000101000001
01010001101001001010000010101100100000011000110000100100001100100000000001000000101000001010000010110
00000100001100111100000010100010001010001000001001100100000010101001001110000000000110100000111100101
00100010101101001011110000000110000000001000101011001000100101001001111100010010001000000101001110000
00110001101100101110001010000000000100011001010000000100000000001111100101100010100010000001000000100
01000010000100101000000001110010000101101000101000101110100000010011001100101010000000010000001000010
01000000000000000100100110010000000000010010111000000110011000011001001100011101000000010000000000100
00000101101101010000000000111111001000010010001000001000001100000010000100001001100010010000011000100
10010001000001010001000000000001010101000101000100000001000001000100000001100101000000010000111010000
00100011110000010100000001000111011001000110000110001110100101010100000000101001111100011010010001100
00111010100000101000000110010011100000000000010000000001000000000000100000001110000010001010111001010
01101001000100100111100010110010100110101101000000101000011000100000000110001000001000000110100000110
00000000001110110000000100000010010001000010101011000010001010000100000000101000010010001001010000000
10001001000000000001010000010000000000001101010000010010000100000100001001010000101000011011001100001
11000000001000100001000110110100101000000000010110011100010000010100100110010001010000001000000000100
00101100011010010100000011100000111000000100100000110101010010100010001000100101001000101110000001001
11000001000101000011000001000000000001100010000000010010010101001101000100000100000000100000011000001
01101000010000100110110000000110010000110000001000010110000001000100100001000001000001000000000000000
00100111100001000000110000010010111000000000111000100011000000000001000110111000000100110100000100000
10000001110001100110110010000101000000110000110101001000101110000001101001000000010101011000000011111
01101001100000001010000010000001000001110001001100000100010000000001101000100001000000000001110000001
00000001101110100110000011000000010100110000000010001000110010001011000000110011010100000010000001001
00000010010011100100000101001100000010000001001110100100000010100010001001010011100000000100100011001
00000000011010100100000010001011101000101000000010001100101010001100000100000010100010010101000000010
00000111010000100010000100100011101000010010000100010011100101000000000001000101011000110100001001000
00100011110100000000000100010001100010110000001110010000000000010000001010000001000000000101101000101
00010001000000000110000000000100001000000000011001000100001011101001001010100011101100101100111010101
00000100000000001010001000010000000000110010011000011001100001000100110000010000000001001110000010000
00000010000000000011101000001000010000101100000010100000100001111000000000101000000000000000000000001
00100100110100100010001001001000100100000000000000010100100000101010100000001010000000101010010001100
01000101001100000000000011000010100000000000000000000000000001010100100011001010000100100011000011010
00000100111100011000000000011001110000001010100000000010001010010001000000010010010000010000000000110
00000000101000011010101010100001000100010110000011011101001000100000111000010010100010010001011000010
10111001000101100011000100100010000100001011010010010000100010010000111001001001010101100000011000000
01000001011000000000001100100000000000010001000100010000000001110110101010000000001000001100010101000
00100111010101011000100111100000001101011001001010001000001100000100100000010100100000100001000000010
00011011000000000001001001000010001100010001001000010011000000000000011000110010010001110001010001100
10001011100000011100100101000000000101110011001010000000010100000000000010101110110000010000001001000
01001000010000101101000100010000100000101111100011101010000010001100100010000100101000000001011101101
00000001000100011011000011010110011100000000000001011011010000011000010000000000110010000001000011100
01000010000001011000100101010100110000010110010001011100001000001001000101110101001101010110000000000
00100000110011000100000000000001010000010000100101000010001010000000010000011111000011001010110101100
11100000001101000000000011101000000000100011001010100000011000101001001000010101000000000010001100000
10100011010101100000101011001000001100000110000011110100001111001010001010000010000010101000100000010
10001010100000110010010100001110110111100110111001000010010100001000000000101111000101000000110111001
10000100000000000010000000000001000100000000011000111000011010010010000100000100000000000110001101000
01001000101010110001110100000001010000101000111000010000000000110101010001100010100001000001100011100
10001100110011001000110110101001010000100011101001010011010100100100100001101001000001000110000001011
10000000011100010010011000010101011000111011010111001000000001010000000001101011000000100000010011110
01100000000011101010000000010000000110000000101000000001100110010011100100010000000000010111100101000
00001001100010000000101000000010010000110100000001101000110001010110110000101100011000010001000000000
00000010101001001110001001000000010101000101001001010011000010000000011011101000010100010010010110010
11000000010000000111000000011001100110000000010000000001010100001001000100011101100000001010100000011
10000000011011100100101000010010000100000111000011001010101000010000000000100100001110000111000000100
01001100000101010100000001010110010000000011000011010011000000001000000010100001011001010100000101010
01100000110001000000000011010110100001100100000000010000101000011100111000011100110010000000000101100
00100111000100000010110000000101000101000001100001100001100000000111010010111110000001110110011100010
00110001101010010010011000110000000000011000000001101011001010101000010100100000010000100010100011110
00111001000000001100000000010001000010010001000001110000111000100100001000001100010010010000000000000
00110011010010001100000100111001000000000011001110000010000000000000010001000101011010000000000100110
10010110011010101100001000000010001100000010000000000111001001000010000001010001000001010000010100000
10110000010100000010001001011100000000101110100001110000110110001010100000000000000101000000010000100
00100000001000000010000100000000100110110100001000101000010000001000000100010111101011100000110000000
10111101000100001110000100001001001000000010100110000000111000011001000100110100000010000000111100000
11000001000010111000000110010000101010101000110001100000010000000101100100001010001001100000000000100
00110000000000000000001000000100000001010000011100001101010001100000101001000000101001000101101010001
00000000010001001000100001101000000011100100101010010011011010000110001000000001000000000010000000000
01101101000001001000000000100010100010000010100000011000000111100100010001001010010101100000110000000
00101100000000000000010010100000100101000001110000000100100100011100111001011000000000100010001010000
00001010100110100010101100000100000010001011001000000000000000010000000010000100001110100000010000010
00001000010100010000001001000000000010000010011010000100001000110000000000110010010000101000001000100
00010001000100000101001100111001000000001000100100000000101010011110100110010001110001000010000010110
00110100101000010001010001100000010000000000000100010000000001010010000010010001000000101000000000000
00100000001110110000101011000001000001000010000001100001100000001001110001101101001000010110000000010
10010100001111011000100000000101101000101001000110111110000010011000000110100010001000100000100100010
01001000110010100001000010100000000011010000000000010000001001101100001110000100000000010010000101010
01000000000010110000000011011000000000010110110011000100100001100010110011010010001010000000000100100
00001100010010010000001011000000000000001001110100110010011101010100100000100000110000101001100001000
00010001001110000100000100101000000000100001000010100111000000010110000001111001000000000010000000111
00000000000000101010000100010101000101010000100011001001100000001100000001101100011011000110110001000
