01000010010100000000100000000010010000001110110000100001000111010001111010001000000000000001100000001
00001001111001000010010001000000100001101000011001010100111101100111101110010010000000001110101010000
00001000000000000000000001100001000000100101010000100000010111001010000010100010000000100101001001001
10001000001010100000010101110101010111000010000000011001000100010100100001001010001111000011000010000
00000000000000101001001100000100000000000011101000101000101100000011110010000100100001100000000000110
11001000011010011000010010000000111001010000001000011110110001100110000011011010000010000010000001000
10000000001100011100000101110010001110001010100100000110010011001000011001100000000000010000101000000
00000000100000001000000000000000000010100110001100001010000000000110101010000000100010000001100110001
00100111100101101001111000000000000100000000100101000100101110011010101000100000100000000001010100010
11011010001011011100000101010010000001001010000011001010001001010000100000000000000000001110101100100
10000000000001010000011000100100000000000001000000000000000000011100000000010010000000000100011010001
00000010111010000101000000101101010010000100001010001000100100000011110101001100000111000010000001100
10011000001100001100001000001100000110010000011010101001010010100010111100110000000001000100100001100
01011000000000100000110001010000000000110100000111000110001100100000011000001001110010011001111100010
10000000011010000011010100001000001000000001001011000000110100000000001110000001100100111111011011010
00111100000100000000110100110010111110101010110000000010001000000000011010000000000001011010000001000
00010011010010000000000001000000000001000100000001010010101100100100000000000000001001000000000011100
00011000000100010100001101110100000100000010000000000000000011000010000110000010101110000110000001010
00100010001100100101011101011000100000000101000000110000000010000111101000100010001100100000000010100
00000001000010100000001010011000000001011011010000001001000010000100000001001010111010001101000111010
11011101110001001000010000110000001001011001110001100100110001111000010000001100101100000010010011010
00000000000000000010000000011000010000010000010110111010000010000010010001000100010000000010010000000
00000010010000000101000010010000011110000000000100111001000000010000000110010000000100000101000000101
00000100010111000010001010010000000000101011101000010000000000100000010000100000001000000010110111110
00001010001100010000001011100000001001001000010100000000000011001010000010011001010100000001100111000
01101000100101100010000000000001101100011001100010011000000000000100011000100011000010010100101010100
00000001010101000000001000110000100000000000010100000010001010100000101100000100000000000000100100000
01011000001000001000000000001011000101101010011000100000010110001000111100000101010011001100000000100
00000001010010001000011000000001010010110111000000100000000010010010010000000100100001101010000100011
00000000010110111110011000010010011101000101000010100010101001001000000011101000000000000001000110001
01101011100010000000011001000100110000100001000000101000000100000111000000010000001000000000010101000
00010100000000001000000011011000011110001000100010000010010100001100100000000110011001000101010000001
00010110101101000101010100001000010000000010000010001000000000010001010101000000100100000000001000000
00111000000000000000000101101011010000101010000000000100101101010001000010000010000000001000010100000
10000000000110001000000000000001000110001001110010001010100000100100100010111110000001000000010000000
01000010010010010000100100000000000001010100110010000000001001001000101000011001000100001000010111101
01000000000000100110000011010001010000000000001000001011010000101100000000010010010110001000000000000
00010001110000000000100000110000000001000110010010000000000000000000000000000100000011000000001111100
00010101100110101101001000100100110101000100000100000000100100010110011011100001111001111001001010101
01110100010010101000010100011000011110100010010100000000001101010010011000000001010001100000110001100
00100001010001000101010000000000101000111001001001100000001000000010111100110001000110101011001001000
10000000001110101000000010100000111100000000000000001000010100001001000111110110000011110010001100011
00000010000010000000010010000101111010000001100001010000000011100101101001000100101100111000110000000
11010110100110100010111010100100101100000000010110110010000010100000001001011000010010001100010101000
11001000001100001000001000001000010010000101101001100000010000101001101100000101000011000100000000011
11100101010010000011001010100000000011001101011101100010000000000000000100000000110000010000000000110
00001011000100110000001001010000101000000100000000000000010000000011100001100000100010100000000000001
10010100000000100110101101010001000101001101000001110011100100000111001011011000010000101100100010010
00000000010111000001111000001101000100110100001000001000110011001010000000010001000110010000011010101
00001000001001000000101000001011001100100000011100100000000010000000110011110110010010101100101000001
00000010000100100000000101010001111100000000011001010000000011011000000000000010001001111000000001000
11111100000001000110001110000000000010101010000000000000100010011000110100010010001001000000101111010
10010010010000001100000000010010000000001111000110100000000100000001110000100010001010000011100000000
00100100010100000001000000000000000000000000000100100001101000100011010001101100001011000000110100000
00001110000110000100100000110010000101000001101000000000000011010000001010101010001011000001000011100
00000010111001000000000100000011010100000101000000010000010010000010000000000100001011000000100000000
01001010001010001100001000110101011100100000001000110001011100000000000010000101000001000000101011000
00100010000000000001000100000000010010000001001110010000001100110000000010000000001001000000000101000
10000001000010100010011001101011110101011000110000101111001000001001011000010100100010001000011000110
01000010000010000010000100000000111000000100000010011001101010100100000001010101010100000100000100100
00000000110001111110100011000001000010000110011110010000000010100100100001101011000001100001100001100
10011000000000000100000000010110010001001011000000000111000001111011010110011000110000001010001001000
00001010111011100101101001011010010111000100101101100100000000000110100001111011000010000000100100010
10100000110000011100001010000010101010010000010101000001100111000110000001010100100001111101000010000
00100000000100000100000100000100011010000111000100011111000000000000100110000000001001000110000010000
01100000100001001101010101011001010000000000000110110001000001000001100001001100110001001001000000100
01100000100000011100010100001000001010011100001001101101001010111111110111110101110010000000110000010
01100101011011100010011010001100110100001111100011000100101000100100000011001000100010101000000001110
10000010011000000000101000010101000000110010110010000101100100100001001111000000000100100000000100010
00000010011000111100001001000110100010000100001010000100001000000110111000000001000000001000000000001
00011000110000011110000010000100000000010010000000000001000001010100110001000110100000001110001000001
00010001010111011001000100001100100010110000010110101000010111000001000000010100111001010000101000111
11100000100111000000010001000111010000010000001000000000000000000000010001000000000010000100011111100
00001100000001001100000000111110000010010000101101110001000000100010010001001000101001101011010001001
11110101010000000100101000000000011000000001010010010000010001000000011000011000101001100100100001000
01100000000100010110011100000111010010001000110011001000111000000001010000000000000000010001000000100
00111000110010000000010001101100111001100000000000000100000101000010010101000001000000010000000000000
01100110100001000000010110100110000101110000000000000011100000000000010010000011010100001100011110001
00000010011001000101000011010011000000000100010110000011000010010000000000110000101010000000100100000
10000000100000011101001101110001100001000000011100000010101001001111001001110010000001000000000110001
10000010011000001000010010000011001001000000011100000000101010000001100110100010000001011000100000101
01100101001100011110100000000011000100000101110001100100001010010010011001000000000010111100111011001
10010000000101101101011100011000000001000101001000001000001001000000000000000011000011100000100101000
00000000001000111000000010000011000101001000100010001010000000100101010100000000111010010100010100000
01010000000101100100000100100100011011000000100000101000000110011101001101000110000111111001000100110
00110001000010011000000100100110101111000000001000010100000000000010000101000001011011000001000000110
00110010001000000100010000000000001000100001001000101000000110001000000000010001100001001000011000000
01010001100000010011001100000011000110010011000001000000110111110000010000000001000010010010000110000
10000010000100001110001000010000010100000001100000001000101000100011001100010000011001100010110100000
11001000001000010010100100010010000000110100010000111000100001100000111100000000000010010001010010010
11010101100001011011001101000010001010010010011001000010100011000000001000100100001100100110100100111
10001001111000000010011101000100000000010001000000010000000110010000010110000000001010001100010001011
10110100011000110010101100000000010100000101001010100000100010000011000010000110001110101000100000001
10010111110000001000001100011100110000000000000000010100100100000100000000101000010000001000011001000
11010000100101101000001000000010010100010000000001000000100100100010100011000000011000001101000010001
10010100101010001011000000000010000100100101000010000000000000100010101001000001100000010100101110100
01010100111111101000100010000000101101110010000000010001110100100100100100010100000010000110000100011
10100001001011000100000001001001110101100000001001101100101100000001110000100110000001000001000001000
00111010100001010010110000100001000110001000010010000001000000110101010000000001110001001110100010001
00010000110001001010000100001000111010010001001001110001011000000001111000001100000101000111000001000
00000000000011101110111000000010100100000011010000010110000000010100001001001000100000100100110100000
