00011000100101110000000000101000000011101000100000100010010100010100010001010000011000000000000000001
01001010000000101000001010010000001100100010000010000001011001111000001000101010101000011001000000011
01000001010000000100110000100001010000001100000010010110001000000000010010011010001000001010001100110
00100011001000110010011000100100111000010100000001010000000000010010000010010000000001110001001010010
01001001000011100001000001101000011110000011010101010011000001000001001000000100000001110011100100010
00010101100000100000001110111001100100100000001001011000000001000000101010011100000101100000110110000
00111000110011001101100111000101010000101110000000000100011000101010101001101001000000001001000000100
00100001010100001110001011100101100110000010001001010101110010100000001000000001101001010100000000110
10100001000000101101001001101000101000000011001000100100000000100000000011000000001000001000010001111
10010000000100000000000000010110010000000010001000000111001011000000100010000000110100101101000110101
00000001000100110000110001001000110100101010010000011000101100100100000011001100011100000101001000001
00110000001000010000000010101010100000100000100010001100101001000000101001000011001000000001000010000
00001000000010000001001000100010000010000100001100001110000001110001010001100000000101001000000010000
01000011010010011000001100000000100010000101000011011001001100111001010101001001010000010001000001100
01000000000010010000100100101000000001010001000000000000010000001100001101000000110000010010000100100
01100000110100110111000001001110000000000110000111101100010111100000100010110000010001110001000010010
00000110010001010010000101011011110101011010000101001101100011001110010010101100000001101000110000010
00010001000010010001000010000011101101000010010000000100000000000000110001110010001100000011000110010
00000010001010111000001010011001000000000110000100101110011000000000001000110101001000000100011011010
00100000100100101000000001010010000000001000001000000101101000100100100000100010101000000001000001000
00000010010010110000000100010101000111000100010100000101001110100110001100000101100000001000110000100
00000000101010000101001100010001000000000001010110110000101110000001000000101000101000001101110011000
00000000010101000010100110100100111111000000100000000110000000110100110000000011011101100100001000011
00001010100001100010111010101000001001010001001000100001001001100100100101001010000010001011001000011
01000000100101100001000100000000000001000000110100111001101100000010110000100000100001000100000000001
00010001010000001000100100000001000011000100000011101001101010010000000000110000100001011100000010000
01000111000001001000110110110000101000110100000001001000111110001101000101000101101000100011000000010
00000000011000010000000000001010000000001010001111000000000010001010000000100100100010101110011101000
00100100100000100100000110000000111100100010001010000100001110000100011100100100111010010100001001100
00000000001010101000001010010000000000100000000100010110111001000010000011000001100001000001100001010
00001000011001000101000111001001100010000001010100111101000000110010111000011111100110000011011000000
00000011110000011110110000100110011000100011001000000011100100010010000010101100000001000110000000100
00010000100100000000010000010000001001000010111100000000100000100010000011001010000101000101011000000
00000001000000011101000000000000010000010001001100001101000100001100001010010001000000000000100010000
00000000100000010000011001010000000000110101001010000001000100101000110100000110000001000000010000100
00000001111001010001011110100100101000010001000000110100000100010010001001100010010100000000110100000
00000000011101000000001000110111100101000000000000000011000101000000001111000000010001000001000000100
00101100000000010111000110001000010010110000100100011000001000001110001000000101100001110001000000000
10010000010000011011000101001011101111001000001001100111010000011001100010001101100001110010001000001
00000000010010110011001110000010001100000000111110010000000000000001001000110100011000001000001001101
10010101001000001010111101010100000101010000010000100000110000100000000001100000111001011100000000001
01000000000101100100010000100000000010010100010011000011010000110100000000100001010000110000000000110
00000010000001100100100100001101000110011011001000001100000111000010000000001000101001001011010000000
10101000001100010100000110100100000000110110000010110000100011000000011100000010000001000000011010000
01000000100010000101000001010000101111100010001101110110000000000010000000000010001111101010011001000
10100011010100101000010010100001001000110001000011011000000010101010110000000001100000100100000000010
01001000001100011000000010000000000010010001000010101001100100001010111010010100001001010000001000010
00000000000000011001001000010001010001001100000001010010001011001000001101110000010101100001000000001
01101000000000000001001101000001000000001010000100010000000011000000000010010001000000110000010011010
10000000000011100110000000000010110101000110000001100000010001001000011000101100000010001000010001000
10000011000101000000000000000000010010001101110000010001001010100000111000100010010100011011001000010
10000101000010001000100011000100000000001110100111100000000001000000010111000100100100000000010101100
00000000000010010100100000000100000010000110000000101100011001001100101001101000000110100000100100000
10111000011000001010100110010011011111100001010000100000110010011001110001000101011100010010110000100
01111000010011111010100000000001000110000101000000000010110010000000010110001010010100001000000100101
01000101100001000000000011100011100001000000000100010100100001000001000001101000101100101010100001010
01001001010100011100110001000100001100011010010001001001010100001000110110010000000000000001000000000
10100000001000001001100001001001001001010001001111100011000011000000000010010000011010000011100001010
00000000000000110010010100000000100100010010000010001011000100000000100001100100110001101000110000010
10001000110100100000101000110000000000001000000000000010101010000111000000101000100001000100000000001
00011111100111000100000000001011000100000110011011001110000100010011010100000111100000000100000111000
00000011000000010110000010000000000000000001100100100010100000110011010000100101100011100001111001110
00000000000100001101010011000001000000100000001000110011001010011001001010010010000000100000001100100
00001100000001010100110101100001000110000000000001000111100000000101111000000010010000100001010000000
00011000010001001001100110000100000001100000101000011110000000010001000000011010110001100001001010001
10001000010111000000111001010101110000000100101010101000001100000010100010001000010010000101000000000
00101000110001001000000001000000000011001100000111101000001001011000011010000000000010110001100000000
00001000100011011010001000100000001010101110100110110001101000000101000000011111010000010000000000011
00001010001000111000010001000010000101000001100010100100101100000000000001000101110010010110010110000
01000010101001000111000000000110000101000100000000001100010001011000000101001101001101010000001100100
01001000110010101001100001110111000000100000010010100010110000000000100000110010000110000010001101010
00001000100100100011000000010000011000011000010010000110000110000100100000011110001010010000001000011
11000011100001000001100110000010110010010101100101001000010110000001010000011000110100100100001010100
10010001010001101100101101000101010100110001000010110000010100000010000001001000010100010010000010001
10010100101001101000010001000111011000000000011010000010010101001100001000101000001000010000110100100
10101000100011001111000001010100011100000101100110110010100100001100000001110001000101100010011110011
11100000000001000111000101010000100011001000100101010010001100111000000101010001001111010110010110010
11101010000000110101010000010110100000000000010010001010100001010100010001001010000000000100010000000
00001001001001000100101000010010110111100000001110001010100110000000000010001001011100001000000010100
00110001010001000011000110001100100000000000100000001011000000111100000001100001010001000100111011100
00001111110101011000100001100101011000111011000000000011010000100100110001000110000000011101100010110
00000111111000001010010000111101001000001110011010010000000110010010100111101000100001000100011001001
10000000110100000111000001000100000000110100000011000011010001100000001100000000101000011000100101000
00010000001100010011000011100001100010010000010011101101101001011000100001001000100001010001000100010
11100010100000000000001011000111010010010000100000000110010000001010010000000000010000000110100101100
00101000000001011001100000000011001000100000101110000101000000000100000000000001010010100001000000010
10011101000011000001001000000010001011000000100001001001011001010011000010000101000000010000000000100
00000100000100000001000100100100011010010000101100111001000000000000100001000110001101101100100000000
00000110100100000010100001100000100101010001000000101101000001000010001000001100101110000110101110000
00100100000001010111000101000001011000000111011000010001000001000000011101000010110011010010010010000
00010000000011100110100000100000010000000010100001101110101001101001001011000100010101000010010100010
01000000000000011101000001010101000100000111100000000100100010000101001000000100110001011011111101000
00011001000000011000000000000010010000100010010011010110000100000000010001101001101010000100000110101
01000000100000001110000100100010010000010000000010000010000110000100000001011000001000010001010000001
00101111000011011000011100010000011000000000000000001101000000111000000101100010001100000010110101000
00001101000010100010000000111000000001000100000011001011100010000010000000011101001001010000000011010
01001001011010010101000011010011000000010101001100000100001000011001110010100011000111000001000001110
00111111010011000000111100000000100000000000000100010100001001000111000100110101000110000000000110100
10110000011000001000100000010001000000101000000010001010100100101100111111000000001010100000101000000
00101011110010100101000011001000100101010000100000000001001010001110010001100110000011011000000010010
01111000010000100000010101000100000010010011001000010000000111000010001000011000000100001001000001010
