01000100001100000010000100000000010000010010010010000101000011000010101010100010101100110100100001001
01100100000001000100011000110000001001101001101000010000010001000000010010010100000011111000111100011
00001110111000010000000000000000000000100110100010110010101001111100100100001010100000000000101000001
11100000000010000001101000010000000110110010001000110001000000000011011001110110100000000101010010001
10000000000000000000101011110000110000000101000100010100000001111000000100100001100000101000010011110
11011000100000000000000100000000100011011100110010111010010100001001001101010000100000100101010100011
01000000000001010100110100010000101011100111000100000001000101001010100010001001100110001101000010100
10000111001001001100110111101000011000110101001000001000100110000000100010000000010000000011000000000
00011110111001110100010100000000100100010010000000000010000010001111001000001011001001010000110000001
10111100011101010011010101100001001000110001000110100100100101000110001000000000100100001000100001001
11110000010010010000010101010000010011100110000100010000100111001000000001100100100000010011010000010
00100010001000010001000000101011010010010011010000100000010010010011000001000101101001010001000000010
00100000000000011101001010110101001000000001000100010010000001000000000011011000000000001001001001000
01101001010001011000010000100111000110001001000001110100000100000001001000000100010011000010001000001
11010100001100010010000011001000001110000000100100000000001111001000010001001010000001000000101000010
00100000101001010010000110001010000001001000011000000010010011000100100000010101000000110100100001100
00100011100000000000000000000010010110001100100101000110010000001000001000011000111000000010101000000
10110000001100100010001111000110100110110001000010000011010000000000010000001000001000000000000100010
00011000100001001110000001000000010111110000001000000001001000001010000100000100000000010000000101000
01100000111000100001110100111101000100101001010011011000101000100001101001000010001000000010010100101
00010101010101000101110001010001010100101100000101010000000010001010011001100000010101000000000100011
00001100000100100100100000000010111001110000000000101001000110000000001100100010001011100110000000001
10011110010011100011100000010000010100000011101100011100110000001101100010100000110000001001000010000
11010011100000001001011011001010100001010011001100001010100101001000010011011000100100000111101101101
01000000000011000000000001100011010100000000001100100000000000000001001000110001011010011010011000010
00000000000000001100011110000010010000001011110011000001000001000010001100100011100010010001010001010
00001101100000100110000100001001000000001100100000001000110001101011000111000000011111000100111110010
00000110000100100110011100011011000100010110000000000010000100010010110111000000000101010000000010000
00100000101110001011100000000001010111001011010011000000000000000000110101011100110001000100001110110
01100110100100100000100010100101000100000000000000001000000000010010000000010010000101100000000110000
00000100001011110000000100000000000001000000100010001010000000100011100011000000010000100100000000000
11110000100001111000001001001010000001000100000100010010000100000000100000000000000100000100100110100
00000000010011000000000101000100011010101110010000011010000010000000010000101110000011000000000001001
10001000010011000000100001001001010000010001100110011111001111000010010000101000001010111000000001000
00011000010001000010000100000000100001101011010010011011011010000011100001100000100000011000010101011
11011101100011000000001000011010011010000100000010000101001010010000101001000111100000000101001111110
10001011000001000001010110010000000101001010000100000000000010000000000000000101000000001011000000000
00010100000001000100000010000010001100001000011000000100101010010010000100010100001010011000000000000
01110000101100000010000011110011100000000101000001100000101010001001010010001100000001010100001000010
10010000100000001000000010101000000001000010000010011001001001101010001000010001011110001001010000100
00000001110001100110000010010001010010000011101001000000100110000000010000010001100010000100111010000
11000000000010101100110001000000010001100011000001001010101000000010000000011001001000000001001000100
10010000100000001001000000011001010111100001000011000001101001100111101101010000000010110000100000010
00010001000000110100011000110010010000010010000011000110001100000000000010100000000000010010001101010
00000010000000111001011000010000100111010101000100000001000110000010100000011001000001100100000100000
11100100000110001000100001100000101011100000000001011001001001000101100100010000100000000000000101001
11100000000001010100010010000101000111000100000110000000010001101001000101001101000000011111001000000
10000001000100001000000000011100011000011000000000010000010000010000001001001000010001110001001000010
10000000101010010000010001000011001000000100001001000100000000010001000000000000001000100001001000000
01000000000100111011101000110100000010100100111000100101011001000010100000000010010000010110101001110
10000001001111010110101100001100000101001100110000000000001000000000011001100010100000011010001000000
00100101000010001001110000000010000101000000100001010000110011110100000000000100000001100100000000001
00000100011010101000010000101000011011111011000100000001001101000101101000011000011010000111000111000
10001000100000100000100100001000010000100100000000011000000000001010100100100111010100000001010110000
00110000000001100000000110010010001010000011101000000100100000000000000010110000000101010000000111110
10000010000001010000001000001000000011111000000001100000000110000001010001110101000000000001000000001
01100100000100000010000000100000110101011001000000010010111101000000111010001011001001101000010010000
01100000000100000000101000101000000101101000001010010000001011100011010001000100000000000001001010100
00100000010000100000100000000000100010101100010000000001010101001001010000000110101001110010001100000
01001000110110100100011000100000110100010001000000100011001100010000010010000001100000000110010000011
10100111010100111111010101110001100000111110010000010000100000110000101001000000100010000010000000010
00011001000000010010100111100000000010101011000011010000001011000000010000000000000000000010100010000
10000000001000000100100010000100101000000001011000010010001100001001000011001000000000101011010100110
10011000101010100101101000000000000011000010000000010000100100100010001000000000000101010000000000100
00000010000000001000011000100000000110011000000110001100011000001110000100001000000001000100000000000
00101000110010101001110001110000001000000000000000001111100001111000001110001011011001000100001011010
01011011101010111000000000001001001000000000101000011100001000010111001101100000000001110000101000110
00101001101000001101000100011000000001010000001100000100000001010001100001000110000110000000100100101
01000010111100111001010001000000110000100101001000010010001000001000001011001010100111001111111100100
01100101010010000000011000010000100000101000000000100000001100010100011000000101000111101001010000000
10010001100000000001100010001001010101000100100011000100101101101100110101110000001010110110100000000
01001000101010001001000101000110010010100001000000100010100010010001101001100010000000011011001000000
10010000010011000001001100111100000000000001000000000000100000000100001000000001011000101001100000110
00000010000100010100000000100001110000100000100000010000011110100100010001001001000000110001000010000
00010000100110001000000000000111011111000000000110000100100101011001000000100011000010000011001001111
00010000010110000000010001000000101001010001110000100110100001000001101100100000111000000000000001110
01101100010000001000000111100000000011100010001000010100000000010001100110000001100000000000000000011
00100010001100000010001010000011100000100100001100000100000010001100000100000100000001001000010010000
01010000100000010100100100011101100001100100000000100011001100000010000100100000000000000000001100011
01111001001011100000001000000100001001100000100010110001011000000011100001000000000001000001000001000
11000010010011110010000001100010100100110001000001001100010101100101001010110001000000101001100001000
00001101001001100001100000001000010010100000010000100000001100010001000000100100000001000000110011000
00001100101100001000111000011101010000001000000110001110000100111010111001101000000100000000100100000
10000000001011011001111001000100000011100100101000100001000101111100000000100010101100000010100110000
10000101001101010100100000100110100001010001000000001001100000100000101000001100001000000010110001000
00011001110000100010001000001000101100000110001100101110110000100000000000101100100000100000000010000
00110000001000010010011100101000000010111001100000010001011011000010110000001110011110110001011001000
10010101011100000000011000011000010000100000010010100010001100110000011000100001101110100100101010010
00100000000100001000110110000010101011100001011101100000000110000001010000000001000001001000001000001
10010000011010100001111000000010001000000010011100111100100100000000000011010000101100010000111001110
00011000000110101010000000000101100000001001111000110100110100110000100000101010010000010100110000010
00100010011000110100000100010010001001000000011110000000010101001000010100100000000000110010000001100
01000100101000001001101000010000000101100001110110100010010000001101010110000011010001011000001110000
10100010000100100000000000100101000000110000100010101110001010000110001011000000010001000000111111001
00100110000100111100000100001000000010000001100100011100010000000000110000000010101100101111000100000
00111010000001100100110110000010001000001100100000000000101000100001000001100101101010111101100010101
00010100000010000110000010000100010000001100000010101010010000100111000010000010110000100000001110110
10100000111010110100000000100000000100010001000010101000001000101100100100000000000010010000011000010
11010000111100100010000001100000000100000000001111011100101000101111010000111010011000110000000100000
10101000110100000000000010000000001101010000000000111100000010101100000101100011010100010001000000000
00100000110000000000000000010011010101000010001010001010010000000100100010000000100100000001000110000
