00000100001000000010101101100000100101100111000001000100100001000001000010011100100010100000111110010
10000000100000000001001011100000000100100011101111001100000010100101010001000100010011000010000000000
00101000011010000100000011001000010011000001110110000110001000001000101000000100111011000001010000100
00000100000000000001000000010010100111001000000000010101100011000001101110000000001010010001000100010
00001110100010000100001100010001010110100000000000000000000000000000000101010110010010100101001100000
11010101000001010101100100000000001100100100010000111110001010001001101011000000011000000011001010001
10011010100110011000000011001100010100010000000000000011000101000110101000000010110100001101000100000
10101001000010010000100000000100100100010110000010010000101001000011000010110000000000000000111101110
00100011101011111001010001000010011001000000000011100000100100000000010001000000110110000101010000010
00000101010010001010000111001000000100001000001000000000001011001000000001100100000010011000000100001
00110010001101100010100000000000010000010010110011000011000000000000000010000001110011000000000101001
00101110111100000000000100000100000100010000100111001100001000000100110001110100100100100010000010001
01000101011000100010000000101000001000010101010010000001110110000000001000110001010000100110100000100
00100100010001000000000000100001000000100100011000000100000110000100010110010000110001100010100001010
00100110001000000000100100010000001010000000000000000001010110010000000000101010000010000010000011000
00000001101100111010000010110010100110010100010000100100100000000100000100101011111101110001010000000
00110010000010001100000101010000011000000000000010000100000000001000011001100100110000110010110000100
00110100011100000001100100101110001000001100000101011110111010010100001000000100100111000001011000000
01000000111001000010000010000000000010000001100001010000000010011101010000000000010000100000101100000
00000000001000100010010101001000001000010111001000101000000100100000100010101000000101010011001000100
00000000000000000110010000000110110000000000101010000010000111000011100010100010010100000101011000001
11001010011100001001000000000001010001010000100000000010000001100010001000001110111000101010000100101
10000010101000111010110110000100010110000000000000010010000010010010100010000000110100110100010000000
10010100001110010001000100000101111000011000101010000000001000110000011100100000110110110001000001000
00000010001101000011000110111001011000000000010010110000010000000000000100000000011000100000000010010
10000100000000100101100000000111101110001100000001100011000100000001110011101000100001000010000010000
00000000101100100100100010111001000010000000001010101000000000001011101001100000110010000110000011100
00110000000110000000011010100000110010001000000001000110010000000011010101100000000000010001100100000
10010000111000010010000000001000000000000011000000000010001101001001001100101101010000001000000000000
00011000000000100010100100010001001100000101010000000000000001001001010000000001010010010110001101010
00000000000100000001000100011001110010111001000000000010010000001000000101111100100000100000110000000
11110000001000110100001001110000011101100110110000000000010000011001000100001000001000000100011011110
00110000101010010010100000000010000000010001101000010000001010000000100000100001100001100100000110000
01001000000010000000000010100100010111110010110001000100000001111101001101000001100110001001011100000
10001000000011001000111000001000000001100010000000000001100110111000000100001000000000000100010001011
00001011000101011100100011010101001010001001000010110100001010010000001000010001001000011101111110000
00000101000000000110100000100000010101000000001011000000010000000001000001101001000100110000000001000
10100001000010100001000000000000001001001000000010101110100101100000110001011000010110000000001100000
01000000100000010000001001000001001000001001011011010111001100100000010001000001101000101100001010100
00011001000000100000000100000101000010100001000011001100000000100000000101000010100011100000011010001
10000001111000110000000000010001100000000010101001000010011001010000011110010101010100110101011001000
00000101000001111101000000110001010010000011000010011100001000010000000110010100101010001100001000101
00000000001000001001010010010010100010000010010100101000011000111000010100100100111000001000001000010
11001000100010101000000000010010100110100101000001000000000000001000101000010100010000001010111101000
10000110010010011111000000001011000000011100100110000101000111100001000010000001000000000101100000101
00000110000100000001001011000011010001000000000010000110010000100100100100001110000000010001000110000
00100000101000100001000110000010101111100101000101001000000000000000010000000100010110001101101000101
11010111010000000000110100100000010000000000011011001001011010001000010100000011000110000110000001010
11000001000100101000111000001000100011000000101001010101010010000101111100000010101001000010011001000
10000100000000100000000000111000001000000110010000010100000011000101110110001010100100000100100111010
00000110100010010110100100010000010000010110010110100100110011100010000001100100010000000110010000001
00011101101001111100001101100101000100010010000001000011000000110001010010110000001100100011000011000
01001000100001011100000000010110100010000100100001111000001000101010110001010000000011111000001000001
01101110110000000000000001001000001010010001100100001011100000000100000010010010000000000101100000011
00000000011101011011010000001000010000100011010000000001000001001000000110000001000100011000000001000
01000000100100110000000100010000000000100010100011000000000011000001011110100100011000000010000110110
01010100000100001001000101010000101010010100000001000000011001000011010000000001000000001001100000000
00100010010001100000001010100000000010111000011010001100010000001011000101000011000010001000000010100
00101000111000000010001000001000000000001111100000001011000011010111000010010000010100001000000001101
00000100010101100100000001000100000000101001001000000001100000001000000000001110100110101000001000001
10100100100000110000010000010011001000001000100001110110010000010000000000000000100000001110010010100
00010111001001100000011000000000100000000111001100100010000000000001000000001000001000111000001000000
00110110011000010000001000100001000000101000010100000001000000011010010001110000000001001010100000100
00000010000001001110001000001000010001010001100110010110100110100100010100000000000010010110000011000
00000000101000100100100010011110010100011001000010100100000011001011010000010010000000010000010000100
00010010000000101010100001010001001111000001011000000000001010110001010000000000001001100001110110101
01100000010011001011001100110000110000110001000100000000000100000010000001000011001100000100000011011
01000100011000011010010111011010000000000000101100000000011100000010111000100000001001010000001000000
01010000000000001010010011001000000010100001100100001110100000011000001001000000100000110001100010000
01001001000010000100110000001110111000000001011010100110010001101010000110010000000100101101001000001
00001001011110010010000101100100000000100001001001110111100011001000010100100011001001000000100000101
00001001010100000010100001001000001000000001000101000001101011100000011000110100000100100000010000001
11111001000100011111000110010100000000010010101000000000101000010110000001000000100000100000000100000
00000000010001101000110001000101101000000010000010001000000010111000011000100101010000000000001010010
00010011001100011000100100000000000000110001000000001000000000000010101001000001000010000000000100001
01100000001001001110001000000000100100100000011000000100000011100100101000110101001101001110010110001
00010100000110010000111000000100100111000000100010001010100100001011001100010000000111110000011101100
10010001100000000001110000101000111010100000100100001000011010000000010000001000101010100000000001000
00000011001010001000000100100000000000100110010010110010001011000000100011101000000100100001010100001
00100110100100000100000010000010100000100110010000001001000000100010001001010000010011011001011000100
01001010110001011000110100001000001100000000100000010001101001010100110000100010000100010000110000100
01001000000100000000101010000010011001100100110000000001011000110000010111001001001101010010101010100
01000000101010000001000000101010011011000001011000010000100001100000000011000101101000100010100000000
01000100101101000101011100100000110011000110000010001110101100111010010010000000010100001001000000100
00100010001001000010100000011100001100010010110010101001100001000111101101100010110010000011000000100
00100000010000010010000101101010000011100000000110000000000000100010100000000011000010010101000100000
00110011001000000100111010001000001000000001000011010000000001100001100010100011110100011101010011010
10000000011100000000010010011100110000000000101000000100000011000010001011111010000000111001001010010
00000101010100001010000010011011100010000000100110000100100100001000000000000000111001001010000000000
10001010001001000000101010000100010000100000001010000000000100010010010001101000000100000000000111000
11001100100000011100010010000010001001010000010100000000110110000010000010001101110110000100000001100
00001000001001100100000100010000001101110101110011100010000010000000101001100111100110100110110110010
10110010100010010100110000000001000111000010000000011000000100010100100100111100001000101000010010000
00001000010010011001000100000000101011000010000100110101010000001100000001100010001001001000110100000
10000010001110100000010000010000001000100000000000100000000001110000110010000101001110011100100000110
00000000010001000101100011000111000100000100001111010011011000100110010101100101001001001010000101101
00000000000010100000000100000000000010110000000100100011000000101010000001100000000001001000001010000
01101100100000010101000000010000001011101001000001010110100011000000010010010000011101000000010000101
01001000000000000010011000000010010101100010010001001000000000111000011001000010000110010011100010100
10100000000000000001100000001000000000001110000000110000000000110100000011100001000100000001100011001
00000010001100000001100000010111010010111000100110101100000100100011101011000100000110000010000100000
