01001101010000111000000101000001001000110110100000000110001001011000000001100011100000001001110101000
00011111110100000010001001000010000000100000100000100010000010001100000010001011001000000110100000000
00110010000001000001001100100000000010100100010000001100010100010100100000010111111000111000010100010
01001000100101000001000000000010000001100000000011010000011000010000000100000010000100101100000101100
01000010000101001000001011010000010000100100010010000000100000000000001111000101001001110010000000010
00000000000011000101101100001100010010001000000000100100010000100001000000000000000101100000110000000
00011000000010100010001000000100000000101000110110010110010011101100010000000100101110100001010011001
00100000100101100011101100000000000010110000000000000001001010010000100011000000011000001000001010100
00000010101010001100100000001000101000000001110100010101011110000001000000000000011000010010000100000
01100010110000000001010000001101000000010000110111000010000010010001011000000000101100000000010100101
01011000101110100010000010101010110110001110111000011000001000000000000001101000010100000000110011000
00110111000101101000000001011001010000100000001000010100010000110110100000100000000000101000011010000
00001010101010010000001000010100000000001011001000010000000000111011000001000010000000000000101001111
10001110010010001010100011010100000101000011001000000000001000100010001100110101100010000100100011111
00000001100101101011000001010101010000000000010000010000001010000100101100000010111000010010010000010
10110101000100000001011000000100000000010010001000100101000000000010100110001100100010000010000100100
00001110011000010000110100100000010000100000001100100000001000101000000101000000000100101000000000010
00100010010001000100010101000100000000100100100100000000000101010110010001010000000010010000011110101
00001010011011000001110001000000000111100011011000100010000101010010000111100000100000000010101111000
00001010101000001100010000010011010100101001011010000010100100010100010000110000000000000011001001010
00010010010100110000111110011100011111000010110101000000010000000100010100010001001000100010000101110
00100101001000010011000010111001000000000001010000100101001000100101001001011000110011111101010001011
01110000001111010000100001000001000101011010010010101110000000011101000000000000000000000101100001100
10000000000000010101110001011001110000001100010010011101100000100100001110010000010000000001000011001
11000010000010111000000101000010000001000001100000010000011110001100010111000000000100000010000111000
10000011100101010001001110000110010101110000101010101000101100101000000000100100100010100000001000000
00010010110010000001100000100000011000001000010000011000001100011000000110100000110100010000000000101
00001001010010000000100000100110000010000000100100010001000010011001110000000101100000100001001100000
01101010001100001100010110000100100000001000101001001010110111101001000101110100010000100000000000000
00010011000100110000000001110000010011000100000000010000100000100101000000001100001001010010001000010
00100000010101011111000011010010010010000000000000100000000000101111000000010000011100011010000100100
00100000011010010110000000110000001001111011111101110001100000101010010000100011001000010001001000001
00010100001000100111000000011110010001000000011010001011011001000000000011100001010001011000000000000
00100000000000000000000100110000001000001000010100111001100100010101011001100001100000000000000100000
10000010101000110000101100000011000000000011001010000100011110100001101000001000100010001000011011000
00100000000000000000000100001000000100101000101100000000001010101001010010011100001000000100011001010
00011000000001000000100101000000100001010010010101100100110101010010010100010001000001000001000010000
00000001011000000000100100100100000000100000011000001000000110000000100011010001111100010000110000000
01001111101000000100011100010100000010111010011111101000000000000000011011000010100000000000000010011
00100010010110001110000010111000101011010000000100110011100100100000010000101000000010110000100010000
01001001000011000101101101100101011100000000111000011111110000001100010000000100100111000100001001000
00101110000000000000010010110000001000010100010010000001000001100000100011001001000100000001000010000
00000000010100100101000011110010000000000010001000011000000000001001101110000000001000011001000000000
11100000001000000000100100000010001001110000011011111010011100101000000000101000000101010000010000000
00010000100010101110110000011010001000100100101011010000111011001001000000000101000000000000110000000
00001001110011000000011000001011010100000000000010000100011101100010011001000000010100100100110000000
11010000000000100100010100100001000111011001000110110000000000001010000011000000010111000010000010010
00000000000010010000100001100100010000100001000001000000100101000101000000111001000000000101000001000
00011001000000100000001000100100001100010100011100000100001000000011000100110000000001000001101000010
11101000010010001000000000100010010001100111000000000000000001100000100100001001001000100011100000010
11011000000010001010010100010000010010100001010010011000001001001000101001101000000011110110000010000
01101100000000000100000010110101010001001010000000011010000001000000100011000000000000101101000000101
00000000001100111000001001110000010010000000100110100000100100011001000001000100100100111110000010100
00000100100110000000001001001011101100000010000001010000000000010000001001000010110001011000010100010
00000011000000010110110100010111010000001000010110000000000110000001101010000100001010000100000101010
00011000010101010000101000010000000010100011001001101110111000000000001001010000000000000101111011100
00000110100010101011101000001000000001001010110001000000001100010100000010010000111000010000010010001
00000000101100000011000110001010110010000111111000001000110100001100000000011001000001001000001110010
10000000000000111000010000100001011000000001100100001000010100010000010010010000111110000001111000000
00110010101001100001101000000101001000001010000001110110001010011001000000100100010000100000010010000
00011011010000010001010111000000010110000010010100010100000100000010000010100100000101100100000110001
00011110011000001001000010000010001000001001010110100000100011011001100001000000000100000001011100110
00000000010100100010000000011100000100001100111000010111000000000000000010100000001110010000110000101
01001110000000010001000010000001010000001001111100010100100001000001000101001000100101101101110000010
01000001000010010010101100100001000000001010010100001010000000000100011000100101000001000011011010000
11000010101000110101010100000010000010110000100000010011000101101111100001010000010010010001001110101
11100110001100010101001100000000001010000001110111000010000101100011100010000001010110000001001011000
10000010000111001100000001100000100000001100000000111010100000000001000010001001110011100110001111000
10010000011000000001000100011000000000010100010001100000000010111000000110000110100100010001000000100
01100000001011110000110000010000000000110101000011011001000011000100101110001010001111000000001001101
00000001111000000100010000010010001100101101000101000110001001100011001000010101000001101110000000100
00000100010100001101011010000000111001010000100000101000001000100001100100001000100110010111011000100
00000010001000000101100010100110100000001010100101100000001000000011000001100001100100010001010001000
00000010000000100100000000100000100100100101000100000010000001000010001000010110000011101000010100110
00101000101001010000010100011000010001000011000010010000001101000010100010101000000110110000100000000
00010000100000000100101010010000101000000001010011001001010011001011001110000000000000100100011111101
10111000110100000000001000101000001111010001010010110100000000111001100011000010010001100000000000100
01000000111110000101000000001000000001101010110001101001101101011101001100100010110010011011100000000
10011001011101000000101000100001010011100001101011101100011000000001001000010001110000000110101000010
11001001101000100010000000000000000000110111001000000000000010110100000001101100000100000001000001000
11000001110100100000011001001100100010010001100100000110000010011000000110000010110010011000100010001
10000001000110010001000001011101010000100100000000101000000000000000010111100000000000010000101001001
01000100001101000010000010100000000101001101011010010010000000101011000010010010010000000100010000010
10111000100100000101000000000001011111100000000100010110001011000000010000000001010011000010001011110
11000100000011010111001100000000101100000011011000010100000000000001000000001000100110001000101011100
01010100100000000100100100000100010111101100011000010000101000000001000000111000010010001101000000010
10000101010000001010010000001000000010110000000001000100111000000010000001000000010010000000010001000
10000000001000001001011100110001011101111010000100010000001100001001000001011100000000000100010000000
01101110101011000000000100000010010001000000010101001001000100000100000010000000111001100011000101000
01000111110000101000001100000100001100010110101100101100101000000000001000100010100000000000101110000
00110000000011000000000000000101111100001000001011001111101000011111000010000000010000000110000000110
00010100001100100100000001001000000111100100100000010001010010100000100100100100101011010010000001000
00101110011101111010010000110000000000000100001101010010011100100110000001100000010010010000000100101
00000001000010000101001010000101001010101100001001000011000101010000010000001010000000000110100110000
00001000101100110001101000101000000110000011000100001000100000001000101110100000001011010100000000001
00100100000110011001111110000000100000100101001000000000100001000101100111001010011000010000110001010
10000001000000001001111000000000110100100100000100001000000000011001001001001001000000000100101101101
00000000010111000011110000111010110110010100000000000111100101000010010000000010000111110100000000000
01110101000010011110011001011000100010010011010010000100010110001001001000000110010001000000010000000
01100000111000010000000001000000001010000011010010100011100011100000010011101000010101001000001101000
01100001010100100100100011000011001001101100001011101000010001000110000000001011100100110001011001100
