00111001110010010001100001100100000001010011000000110101010101000001000100000001000000110000011100001
01100000101100001001010100100010001100101110101101100000100010001000001001010010000100000000000000000
00000000000101000000110000010000000010010000111110001110110100000001000000010011101010111001100000011
00110100111100001000001000010100100100010100001100000000011100000010001001100000001100000010100000110
11001000000010110101100100100000001110010011001100101101000010110000000111001100000001001100101010110
00111100001100100101110000001101000000110010000000000100010000100100100000111110000000000011000100000
10100010101100101001111000001000110000001000100000110000100000010001001001100100010100100111000000010
10100000100100001000110010100000000000010001000111000001110011010100000101100001011000001000001000100
01100000011000110010000001010101000101000100110101001001011000010000100000010000100101100000111000000
10100000000000100101000110011001000111001011010111010001111000010100101110100000000001000100000100000
00000001100000010011011000000101011000000010000001010101100001100000100011000100001001000000010010011
00000001001101100000100010010001000010000000000001101101000000010010010000001000010000000010011000000
10111000000111001000000011000100000001000000100000011001100000010000000000100001110001000011100100000
10000101100010001000100100000101010000001100010010100000001100000111011000000000010000101101000110010
00010101000000011110001010101000101001011010100001000110001000011000001010000000100100000000110001000
00100000010011000000100000000011100000010000001100011001010000000101100000001110001100101010000000000
01100110111110101101100000000100010000101000100101001001010001111001100001111000001000011001001100101
10100001000110001000011011001000101010000000000000011100000000000110000000000011000000011000100001000
00000001000010110100001001101011001001000110000100000000000001010000001111000100101001110000000010110
11000101010000000110101110001001000000011010010000010100100100010011100001000000011001010010101000100
00101111000001010000000010000000000010100001010101000000001000001000000100100100000111000000011000100
10001110100000000000000001011000100000000001000000001010000000100000110001100011100010001100000110010
10010000100001010010010001010000000010010100100010010001000000100011010111001100110001001000010001010
01001011001010000000000000000010101000001000111100011000100000010001000000100100110100010010001000101
00000010010011000001100000001000001101001001101010010000010011000001000001000001011000000111001101111
00100001000100000000001010001101000010000111000000010010100000110011110000000100011010000100000000011
10001010000001001000000000010001001001000001101001001000000000001011000000100000000100010010000101011
00001001001001000000101101100101001110010000001000000001010110000000000000011000001000000000010101010
00110100010011100000001010000001010011001001000000011100001011000000000000000001101010000110000100000
01001000000010000010101000101101101000010000000101000010000010001001000000100011000000110001010000100
01010001101010110010000000000010000100001100010001100000010100100010000110101010001110001100000000000
00010000010001100000010010010000001000101100011001001100100010000101110000001010100001010100001100011
00000110000010010100000010001100000110010100111010101110000110000011000100111110000010100000000100011
01001010011001101000010000000000110001011010100000000100100111010000110000011100000010101001100010001
00000011100010000000100000010000000000101110001010111000001010000100010001100100001100110110110100000
10000110010010000001001000010011011001100000110010100111100000110100010000100100010000001010111101000
11010000000000000000000100000010101000100000000010010011101011000000000000010000100011000100100000010
00011000010001110010100000000001100101000000010000000001100000101000000000000000100000110001000100000
10110010011110100010000011000000100000010000001001010011000100110001000000010101100000000000100100000
00001000000000000011100110100001000110000001000000000001000000000001100011010000110000000001000001100
00000001000000010000010001000000011100110111001100111000011001110001000010011100010111000010100100001
00110000000010000000000000011000001010100000101100111100100000100001010000011000111011111011000010100
11101000011000100010000000000000001000001000001100111011001000001000111100000001001100000011001000001
01000101000100100110001000100110100100010000010010010001010001110000011000010100010000011000000010000
01100100110001110010001000001001100001100010001011101100010000000001101000010111100100001000001010010
00100001000000001000001000100001001110110000001000001000100011110110000001000011000000000001000000001
01100100000010000010000001001001001011001110100110110001000000010000010001000000011010010000010000000
00100000010100100001110100101001000100000101001001011000000000010001010000001000100110000000000100000
00000011000100001010100100101010000011100011000001000000101100010110010010000100011110010101100100101
00001100100110100010110000000100000000001010010101000001000000000100000101010011100111000000000000110
10000000100000100000101010001010001011101001000110010100010110000100001100100111000010100100101000011
11011001010010111000000100100100100001100001000000100001010001000100010110000010010000001000100100011
00010101100000111001100111000101000011000000011110000001010100110010000100000110001100000111000010000
00000010000000000100000000100100000000000001000001110010011001100100010010001100010100101001010101000
00101000000100011010001010000101000111110010011000000010010110011100100000101100101101101110011010111
01010100000000001001000001110110101010110011100010001000100000000011000011111001010000011101000100010
10100000000000101110001100100100010001010110100110000100000001101000001000100000100101001000000000000
11010000000000010000010100101000011101000000110101100010110001010100101100010100100110100000010010010
01001000110001101000000000100100000101000101010101100010100110000000001001101010000110110011011000011
11101010000001010001001000010100001001100010001000000001100100100001100100011000000100010000010001000
01001000001000000001100111011010101100000000001110000100010100000100100010100110010010000010011001000
00000100000000000001110000111100011010000100001010101110000010010001000001101001110000001111000010000
10010110100000000000000010000011100001000011100000100001100000010101111100010100000010110000101001000
00000001000010001101101010000011110011001000010000101111000010000001110001011011000010100100100011001
00000001000111101010001000010000100000001110001010001000110001000000100110101100100100101100011101001
10110001000111001001000000000000101010100000100100010000001000101100000010000111000100000000001100011
10010000000001001010100010100000000001011010001001000101100000010011100001001000000010001000011010010
00100001010010000000000000000000111000001011110100001000000000001100000100000011001010000001101000000
00001101100001101000000001100000000000000000000100100111001111000010000010010100001000110001001000000
00110001011110000000011000011000000000010101001000111000110011001010000100000000000101000100000000000
01010011101010001010000110000100011110000101001100001100010100000001010110000001000100000000111000001
00010100100000100001111000000000101110000000001000100000000000100011000000001001010001000000101101000
01000100100000001001100100000010000111010101000100000001010000000000100000000001100000010001011001000
00011100000001000101001000001000101111000000000001100000001000000000001010100001001000010010000100011
00010101110101010100011000011011011000000000000100110100010000000000010000101000000111110000010001011
00000000000010100101000100000010100001000000100000000100110010000000110010100000100000100000001010010
00000000101000100001100011000100010101110011000100110010010010001101001000011001000000001001000101000
10001100101011101111000000101100101000000000101100110000000100001000000000001000000001110010100011000
10011000001010110100001100100010001111011100010000010000100001110100010100101101110000001100000101100
00100010001001000011000000101000000010000110000110101010000000100010100110100101011100000101011100001
00001000110011100000100001011010101000100000110100100110000100000010011000010100101000110100000010011
10001000001110000000101001000000010000010101100000101100001000000010010011011001000110000001001001001
00000001001100101111001010001000011000010101100000000000000000000100010111000001000010011001000001010
00001001111001100010011001000001100000010001011100100100000000001000010100110100000100000010000100010
01000011000100010101000100100111001110000011110011100100001100101011001000100101010001100010110010100
00010001001000010100001000000001100000000001000010100011100000000000001010000000001101000000110101100
00011010010110101001111000000010101000000000011000000001010101110000010000000000101101011110011100010
00000001010000101001110000010110000000000101000100111001010110000000000000010001010011001110001101110
01100011000010111010011000000000000000000111000000010000000001000000101000000000001001000011000000101
00000010010011000000010000000100110000101001000000110010011010100010001001110000000100110110110010000
11100010001001011001000111100100000001110000000001001001011000001010001010000110110100000000010100110
00000100010100111101000000100100010010011001010000000101010100001010011110000100101111110010110000011
00001100010000101000100001000111110000001000000100110101001101000000000100010010001101000010110000001
10000010000000000000110000001001000111011100010000100001101010000101011000000000101001010000101000111
01000000111111100000100010011101001000010000011100001010001101100100101100010101000010010101010000111
10000110001000100000110101000011000000000110000110100011000000001001000000001100111000100000000000100
00101000000000000110010000001000000110101000000001011001101100001001001001000010011000000001000100000
00101011001000011001111100011001010000000000010010010110001000110000100000101000010000000000100010000
01100101000000000001010110010011001000101110010000110010000110000000001100001101001000001000000010010
00000010000100100000001000000010000000001001010101000000000001110000110001100001100110001110010000010
00001000001001100000000100001111001000100000101010110100000110000010000011100100101001000000000100010
