00001001100001010001000111000000001000000000111000010010011001000000000111000000100101001110100010000
00100000011100100111010100001000001010101100110110000100100011010111100000010001000001001001111010000
10100000101100110001100001100000011001110001110000001011010011100100000010100110110100110000101101111
10000000001100000001011011011100101110010000100000110110000000000001010110110000001100100001001000011
00101001101110100000000010001110111001100000000100100001000000000000111001000000110011000000111100000
01001000101000100111011000000000010000000000000011000000000000110010001000001110000101000000000010000
00110101100010010100100100100000001000001000001011101101000000100000011011001100011010000000000010100
00010100100101000100100000010000010000111000010000101000000000000010010010110010101001010000101001010
11100010000010001011101000011010011010010011010101001000001000010010100001001000011101000111001100010
01010010001010100000011110100100000000010001010101100000000000000101110001000001011010101010000000000
10000111000101001011000000100000000010011000100010001000001000001000001001001100010000001000000010110
00110100111000010010000011010001000000000100000100000001010001100010100000000101000001000011000011001
00001000000000001111010010000000000010001000000100100010101010000110000000110010000000000110001000000
11011001100110001000000000001100001011000010000001011000000100000000001000010010011100010100001000000
01010010110001010000100000111000010000011100000110001010001100000011100001100001101000001100000000000
01011000101100000100000011000001010010000000000001010100001011001000000011000100011000000000100010000
00000000100000001100000001010110010110000100111010001110100001011000000010000000010000101010101000100
00110110101001000100000000110000100001001110010000100000100110000100001000010000000011110001100000000
00100000001010010100001001000001011000100100001100001000100001000100000100000000100000000000000000000
00010010111100110000011010110100000000000011100110110110100010101110000100100110000001000000000000000
00001101101011001011100010101000000000010100000011011100100110101000110101001001000101000000000100110
01100100001101000101110111111000100010010001010111000000010000000100010101101010000101000000000000111
10011101111000010000100111000111100111000000010010111011000000011000000010000100000110100000001000000
00000001010001100100100010000000000001001001000101111100011010000001010100000010110100011001010000010
00000001110010000010000010001100000000010000110100000000001011000010000110101100010010101000010000011
10011000101000110000100000011000101100000000100000010001101100100001000010000010100000110010001110000
10000001000000000000100010111000001101010000000000000001001000001010010110001100001001100010000000101
10000100100100000010000010110110001000011000000101010000100000010000011001100001000010000101000001000
00111111010000001101100010000010001011011011000010010101110110110001000001001000000100001000001010001
10000100000000010001000110010001000101100110001010100001000000000010000001011011110000000000000010001
00001010101111000101001000110101010110100100000100010000000000101100100010000000001000101100010010000
00000010000010001001000000000000000010010000001000101010110000000001000010010100100001100000010101000
00001000010111010000100100000000000001011001000010100010000110000011100010000100010101010010001000001
10000000010110001100001000010000000000000010100000101000101101000000000110000110000000001001000000010
11101011000000000010000111010000110000100101100000010000100000000111100101010010010000000000000100011
00100011111000000000010000000110100000001111010010111011000000101111001010010000000001000001000000000
00000011011100100000010110100011000001010100001000001000011110000010000001010110000001110001001101000
00100010000000011010100010011110000010010000011100101001100101000100000111001000111000111010001000001
10100010000000001010110101101000100010010001010001000101100000100100000000001000000100011101000000000
00010010000001000000010000010100001101000001001001000010000110000010000100100100110100010010000000000
00001101010001101101110000101111110001000001110001000000011000010010000111101000000000010011010011000
00101010000100101100000000011010000100001000000011010101100001110001000000010000000000000100000000100
11000011110110000101011000110010000010000110000001001101000000001000000110100100001101000101110000100
00100010000101000101010000000000010001010001000010110010011000110110000000001001100000000001111110010
00100001000000100010010101101000011000010100110100010110000000000100000011000010001000101111100010000
00000101010001001001100001100000000000001011000100010000000000100100000000100100101000000000011000000
00101000000100001110011111001010001000011100001000001100100101110001101011000000101010000000100001000
00010000010000101101101001010000101100100100000010010100101010101100010010001010000000000100000100000
01011010001000010101000001101001110010000101010001000010110000010011001000000100000101001100110011000
01001000000110100111001000010001110011000001000010001111001010100010110100000010111000001100100100000
01000000010000000001010000000010010011000000010000100000100000000010000000111010101100010110000100001
00010010010101001000000110010100100100010000100000010000001100101000100010110100000000011000101010001
10100100100000110101001000001000010111000001101101000000000010010010000000000110000000000010100000010
00000010100010000000100000000000000001100100000000000110001100000010100001000000110000000000010100110
01001000010110010100010100100100100011010001001100010000100110011000010000110101100000000100000000100
00000000100001010010110011010000010011000110110000000000100110010000000101001110110110001100000010001
00000100010000000100000101010000000110000010010101000111000000100011010011000100010000010010000110001
11000000001010000011001000010001111001110111000000000000000001000011000000110001101000010001010000000
10000101100010110100110100010000010100001000110011010101101111000010001000000000011001000000001010100
00001010000100100100000101100010001000001101001000100010101000010000110000000010010001011000100011010
00100010100110001000111011000000010001101000111011000000110001000110101101001011100011000000000010000
00000000000001101010100010000100000010001000000011001000010010100000100000001010110100001000111001100
00011001000101011011100000001011110100000000011010110000100101000010001000011000010011000001110011110
10100000011101110100000001010101111001010100101101010000000101100010111001001011000100000001010011000
00010001000010101110001000110000010111101000001010000011000001110100001000000010010000100001000001000
00100000110010010001011000011001000000010010011001101000000010001010000000110000010010001100000001010
00010001100000010000110010100000111011000110101100000000001100100000110000001000011100001100000001000
11101100010000010000000100100101100110110000000100100010100010000001000100010010010100110000110000011
01100001101000010001000000010011000100000000001010001111010011000000000000101010010110010110001001011
01001000000100000100000100001000010110010001000000001010001001010010001100010001001000000010001010001
00001000100000000101011100101001000100100001010000000001010000011001010000000100111000000101010111001
00000010000000011011011110000100000100011000011100000001000000111001000001000101011010101000001110011
00001010110001000100100101001000100100000000000010000000001100001110011100100110110100100110010101011
11101101010000101010000010010101000100100010010000111010110000000000010101000001000000000001000111000
00010001110011010101010010000001110000000010001010010011110110000100000010010010000000111000111001010
00101111010000100110001100000100011000000111100010001000100010100111000001001000000111000100010100000
01110011010000100101100100000010000000000001000111000010100101100000000100100101100111001100000010110
00010000001110100000001111000001001001001010100000001010000001110000100000010000001100001101000000011
00000100110000000000100111000101000110010101010001001010001010000101000010101000000100000000000101101
10100000011110110001100101111000100000100010000000111101111000101000000011010000000101000000110110100
00000101100001010111010000000000001100010100011000010000001100100000110111111000001101011010001000000
11010101010000001000010100000000000000000001000110000110010000001001001010110000011000001000000000110
10011000001001100000100101000000010000100100000100111000011010010101100001001101000000110101101101100
10000000000001000000011001000000101011000010001101001001010100010000010100000000111000011000010000000
10010000011010100010000100110000000001010000001010100001010110011010001001010000000011101010010000001
00011000100001010010000001010100101000000000101000001100101010000010000011000010010100000000100011011
10101011000100100001000000000100000000011101110000101000010101100000000000010110110000100100000000000
00000000110010101110001000000000001010000000010000000000000001000000110000110000010000000010010111010
01100010001000001001001100010001000101010000001001100011100000000111000010011001110001100010001001000
01100001010110000101011010100110010000000110000000110000100001000110000000000111010000000100000000000
10011000000100000000101101011100010001110000010100101100100000100110100000010000010001100110100010000
00010001110000000101010001110101001001011010100000100110000011010000001110000010010000110000001100101
00100100011000000000011010001100000001100001000001100000000000000000000000100000010110111110000000010
00010000100100011100000000000010000010100111000101000000000001000010000000000100000010001100000000100
11110001110000000010000000000010100000011000010110001010000010010001011000000001010100000000000010000
00000010000100110000000111000100010111001001001010010101010000000010000010010010000010100010000010101
10010100000110010010011100010000010101000000000000001001110010010110100000100000011000000110000000110
10010010000010000000000010001000010000011000101110000000000000110010010000010011000101100000001010100
01001001100100000001010000000000000011100000110001001000000000000000000001001001110010101010110010000
01110001010000011101010000001001011100100000000100110010000000001101000000100001000000011100000001000
00111000010000010001010110000000101100000111110000000000000000001000101010101001000001011000011000110
