00100001011000001000110010100010000000010001000011001000000100010000001001010000110000000001000101010
00000100001110001000100100000001000100010000111101111110000010010101011010000000100001001000000101100
00100010111000001001000001001100001111100011010100000001100011000000000000010010000101000011100000000
00011100011011110100000000010011000001001000101100011010000010100000010000100000010011010101000100000
10000000001000011000010000110011010000001000000100110101000100000000101000000010010110000000011010001
10010011000001000000000010000100100001001000100110000010001110001000110101000000001100110001010011011
00000001000000100010011000101000010001100000100000110110010100011101011000000001000110000111110101000
01000000101001000110100010000000011000000110100001101000110010000110010001101001110001110010000110100
00001000011111101000100101000101000000000001010010110110010000000110001000100001010011001010001000100
00111100100000001100001000001100000000000001000000001100000010110100000011000100011010000100000100001
00000001101000000000100000101000100010101010001001000010100101010000000001000110000101100000010010010
00000011000100111011000001011100100110000110000000001000001011001100001100000101100100110101010011110
00000001100101111000000010000101010110000000000100001111000000010000010011000010011100011101100000101
00010010010001100100100011100011101010000000100000001000001010110100000000010000010001001001000100101
01100000111101001000100100100110101110000010000001001001101000000100010000001011100001110000010000101
00010110001000001111001000000100000000011110000100010000100100001110010000101010000010100000000001000
01000110110100001001000000100010000101000000110000010010001000000100100101100010001110001000001010001
00110001100100000010000000001010100010010011101000001100001100000001000100001010010100000010000000111
10110001010001000000100100001000010010011001000000001000100000000010010000011110001001100010101000100
10000000001100010001000100000010001100100000001010000001000100101110110000001000001111010100001101001
00000000110000000010000011000010001001001100000010000001110011100100000110001101100000100110000001101
01000000010100000101000011000000010000101001110100001000100000000001010001001011100101001000000010000
00001001011100110000000000000000010000011100010000001010011111101001011010000100000000111100000100100
00100011000000001011001100111010101010001100111000100110010000000000100010111000010100000100110000011
11000100110001001011001101000110010000010010100001100100011000101000000111100010000001001000001110000
00100010000001010110101000000101110101100101000001000101000001000100000110110011010001000010100000100
00000010100011000011000010011010000000110100100100000001010001010001100000010100101001100000100001000
00000010000001100000111010011000000000101111000101000001000000110010000000000011100100000110101010101
10100000100101001000000000001010010100010000010000100000010100001000001000010000110001100000000010010
11000000000010111000011100000011100110110011100000100000000100100010000101100110010110000000100101000
01001000100000000001100001101011000001100010101100100001100010001100001001100010010011000010000100101
01000100000000001011000001001000100000000010000000000000000100011100000000011110001001001010000000110
11100000000010100000000000110001100101101000000000000000000011000000100000011000000110110000010000000
00100100000010011000110100010000100001101111000000101000000000000001010001000100000000001101000101010
11000000110000000000100001001010010000100000000011000001110010011001001110011000000001000001100000000
01100000100001001010010000101100100010010000110010000101100001010100110001100101010001101110010010100
00000001001100001010000000010000001100010011011100010010010000000000000011010100100000101101011010001
00010000000111000100011010000111100000010000001000000001110101001000111000100000000000000000101000000
01010000000011000000010000111000100100000100000000000000011000001000011000000101000001000000001101001
01110010100000010001000010110000011000010100001001011000010000001001100011000001001110000100000000000
11011000100100001111100100001000001000000000111000101000001000001010110010001010100000110000000100101
10000000101111000000100000100100110001000000110011001001000100011101110000001100111000110100000001011
00010010100011010000100100100110100000100000001000100011010101001001001001000001000110010000011000100
01010001011000000100011100010100001011000001100010010110001100000101100111001000011100010110100000101
00001010000001001111000110100101110000010110010000001001000010101101100010010101001000100010110100010
01100000000011100110000001000101000000001110011101000000100110000000011000010011101010000001011011010
00001110100001000011010100011000110110010000011011000101101000000010100011000000100101100000000000000
00000000000110000001111010001001010100010000101000000000000011011100101000011100000111110101100101010
00000100000011110001001000001010110001101010011100001100001100000100000110000011000010000100110010100
00011011110100010100100100000000010010000001001001001000000000011010000000001001001100001110000100000
01001010000000111000010010100000001000000001000000000100000000010110001000011001100001000011000011000
10110001001000000100011101010010000000100000011000001010010100110000000010000011100011100110001001010
11001000000100001001101000000111101000000000000100000001000101110100000010100000000100011000100000000
01110110010001010010001100001000110010000100100101010000100011001010000010001001000010000110000000000
01010000001100000100100000100101101010000100100001101000010010000100000100010010001010000000010000001
00010010001000001110010001110010000100110001100101100010000000100000000000001000000011110000001001000
00001000100000001011010000000011100110010000010001001110000100101000000011100011011101010110000000100
00101100100000000101001001111001001000011010000100010000100111000000001000110100010100110100000011111
00010010100000000001111010000100000000100100100100000000000000001001000100100011000010100000001100100
10101000100100000000110000010000000000000000001000100010000100001010100000100000010011101100011101111
01101001011101101010011010010001001000000000100001010001001100101110010010100101100000000000010000000
01101010001001111000100101000000001101101001000000100000010100100000100110100010000000000000110000100
11010000101100110000000000000000010000000101100011101100110100000000000001010010001000101000100000000
00011001100011001000000010100000000000100110001110000111100101000111101010010010011010010001000000011
10000000001100010001000010001100000001001010011010000110010100100010100000011010000000110010001010000
00010010000011000010001000100101100001010011100011100001100000000001000000000100000000101100010000000
00010100010000100100100000000001100000000010001110001100100000000110000001100000100000000000001010000
00011101010100000010000000001101001110110000001001011010100000101100001101000110001010101100001000100
00100000110010001110011000001000110010100000010000010100000001000100000000001100011001001100001000010
11001000011000011000000010110010100001000010001000000001100000011100000010011100000101000010101000001
01010101101000010011000110100001101000000100000110000100000100011000000001000000010000010001000100011
11001100100110011000000010110010000110001010001000001011100111010010001000000000010011010001100000000
01100010100100010110000000001100000101000001110000010010010000100100101010010110100000000011101000001
10001001100010000000000001010100101000000000001110010000101100011000111000001000000100000000101010100
00011001010000101000000010101000101000010000011000101000000010100110010000110011000101000000000000011
10101101100110100101001100111001001000011011000110100001110000000001001000010110000100111010000000000
11000000000100000000000100010000000000100001000000000110110000110100101000010010000010000001000000010
00001100110010010100011010100101000111010110100000100011000010000000100010010000000100111110000001000
00101001010000000001101100000010100110101010011000000010101000111011000000000111000000101000000000110
01000110100100000100100000101100010000001000000010000000000011010010000000010100100000000001100000001
00000000010110000010100100001000001011111110000011000011011010010000101011010110000000010101001001001
10110101100110000000001000000010000001010110000011000100000110000110000100011001000111010101100011010
00010010000000100111100011110000110011000101000010110111000000000100001000000000001000110010001000101
01001001010110100000001001110000010000000101000101000001010000001011000100110111011001010110100100000
01100101011111000000010110000011000000100101110000000000001001000100000000001100011001000000100100001
00010000011100110100100000000010001101010000101001000001000110010000101000000100100000010000000001000
01100001100000000000001110110110111001100001000100000110001000000000000100011000000011010101000000000
10010010100000101010101000001011111000100001000000100101100001001110010001000111110011001100101001111
10000011000000010000000100100110001011011000100001000000101000010010000000000101000011001001110001110
10100101000010000010000001000100110100000000000000100000110110000011000010100111000100100000111000000
10101000011010010000010000000101010100011100000000000000100100001001010000110000000101011010001111001
00010110010010100001010011000001010111110100000000000010000001101001001001001001000000000101000001000
00001010011001100100101101000100000000000000001110100001100111001001100011000010000000110010011101000
10000011000101100000010001100000001000000011100100111010100100100000101110010000110010001001011100000
00110011000010110000011000110110000000000011010000000100000010000001000001101000001100000001000100000
01010100100011001000010010000001010101011101010000000100001011100000100000011000110011000100100000100
10010100000110000110000101001010000000000010101010000000111111000011100011000101010110101000100100000
01001001010000000010101100000111000000001000000000011100000001001000010001100001010001100010011110110
00000000001101010000010000010110000000110001101011001000000010101000010000111000100000001010001110011
10010100000000011001001000101000111100000010000110100000011100011000011101100000000110100000011100100
10000010000001100100101010000000101001000100001000100000001010010000001001001101000000110001010111100
