01000100000001000010010110101110000111001100000101101000000100010000000010000001110010000100011010001
01000010110101000000010000110100110100000001010110000110100000100000000011010000000011000000110000000
00001010000100110000101001000000010100000100010100100101010000100001000100000100010001000101001110001
00010000000010001000100001000000001110100000000010000000101000010000000000100001000011000000010101000
10111100000011100000100110010000000010010100000010100001010000000100010111000001000010000010001010010
01011101000100100000100000100101011101100011010000010000001110000000000011000100111001001000010101000
00111100011001100000111101011001000010000000111000000100100100000000000110001110011000000010000011000
00000000000001000000111000101101000000000000001000001010101000001001000011000100001010100000100000011
10011000101000010100111001010001011000000101000000100011011000000100000100000001001000000000001000100
10000010001000100110000000100100010000010011101100000000010000000011001101011011000100000100000001000
00001000110001100000000011001000100000010000000010100010000000010001010000001100001010001100100110101
00000000000001000010110000100000110110010000000000000000000000000110001000111101100100011010000010000
00010010000101110110000010111110100100111000100001010100011011011000010000110001000000100011110100000
01000000101010101000010000000000100001000101100010000001101100000100100110100010000100000101001000010
01000010110001100000000001011110001000111000011100001000000000100001001000111001100001011001011000000
10100001000011101011001110001010100000001000011010000010000000001001001001000000101110000010000011000
00000110000010000010010001000101001001000000010010110001000101100100000000010111010100000010011000001
10000010000000000010000111000100010100001100100100110000000110100000110011000000000010000001000110010
10000001101101100000100010001001010001011011011101011000010010110011001001000100001001100011100100010
00001000011100000100000101100100001100000010010111000000000010100000100001001000010111000010000000001
10101110100110100000001101101110000000010010000000001111001001101011111000010101010001010000000110101
00100001000010100000001001110001100110010000000100010011001000010001000011010000001011000001111000110
10010101000000100100000000001010010010010000000000000001000110000100111000001011100100010011000101100
01101000011100010001000000011000000010000001001000000110000110000001100000100000110101110000000011000
11010001000001000000101101000000100011100010000110001000010000000000001111100110000000000010110000000
00011010100000000010011001000000010000100001000001010001101100000110000000000010101100010000010000000
00111000000010010001110101100011100000010010100000011101100000010000100000010000010001011100110000111
00010000110000100100110111100000010000000100001010001100001010111100000110110010000101001001101001010
10110001001000000100010000010101000100011010000010000000011000001100011000010001000010100100000010010
00000100001000001100000100110000110100000001001110001110100010000100000001000001001010000001011010000
01000010011011000010100001110010100000000000110000100010000100000000000101010010100100010100000000100
10000000110010100101010000100000110010001100110000010000000000010001001000010010010000010000000010001
00101110110000101100000100100100000110000000001000000010001010111010000000010110010010010010110100000
00100000000000101100010001000110101101001001000000001000100010100000000100100101010100110100001011000
10101100110100000100000001010000000100000011100000011001000000101000000100001110100101001000101000010
00000111011010101000000101000001111110001100000011100000011000000000000010100000000000001000010010001
00110001001111100110010111001010000100001000100010100000110101111110101101011000000100000100100000110
01000000100101100000011000100010100000100100100101011010000000010011000010000101100001100000000101001
00010000000101000101000001111100010000101101000101000000000001010100110000001000000000010001001001100
10000000000010010001000100001000000100010000010001000000001010100001100010111000101100101000000100100
00000100111100001110010000001001000001010000101100100101010100000010011000100110011011000001100100000
00110000000100000010010011000100001101100010010111000000011011001000000001010000010010100100110101000
00010000100010001001000000001110100010100111110000001100000001001010100111011000011110100100010000011
00000000010001000010110000101000000000000110001010010000000000111110010100010000000100000010001100100
10101000010110011010000001011000011001001100101000010001101001100110110001000000001001101101000010010
00100100010010000100100000110001000000010000000101001100010000110000111000110100010001100001000000101
01100000001001010001000001010010001000010100011000000001110000000010110100101000010000010000000000110
10010000000101011001000101000010000101010000000010000100010001000110100100000010000000001000000010000
00001000000000000100101000000101010101010101000000010000110001110100110011001100000000100001000010000
10010000010001010010010001011001011000100100100000010000000000000001101011011010100000000000010010111
00001001000000010000000101110001000010000000000010001000010000000010000000000110000011011000110010000
10000000000001000100000110110110000000011001000001101010001100100110110010000000000000110001000011011
10100011001011000011001011000000010000010011011010000100110010100001000100110000001001000011101000000
10001001000010111100011001011110000000001110000001010000010000101101100100000001101010100000100001010
00000010010001100100000010000000110000000010000101000001010000000010100000011001110000111100000000001
00101000110000000010000011000000000110000110001100001001011000110010000010000100000101000001000011001
00001100000001010000101000000000000010001100100000000000100011011100001000010001010000010010100000100
00011000100001000001010000011010010000100000000000000000101000100100001111000100000010010001000100110
01100001000000100100001001101100011000000001001000001000000000010100010000000010100010100001100100001
10100100010010000001010110000010000101110000001000011000110000010000001001011011100010000010100010001
11100010001010000010000001100000000100000101010010110011000110000000010000001001000001000000110001101
10010010010011011010100001000100000010000011010101000001010000110101100000001100011001110001000100010
00000100100000001110000010111000000000000000001010110001010100000100111000010110001001000000010000101
11001000000101001010000000111001100011110100001001000010000100000000101010001111110001100000000000100
01110010101001001101001010010001100000011101010000000000000010010010000100000101001011101001010000000
01111100100110100101000000110101110100110000100000101000001100000001001001100000010001000011001001000
00000010111000000010010000110000100000101000000000011100000000001000001100000110001000000100110001100
10001100010001101011101100010010001000110010011000000011011000000000011000011000010000101010110001000
01111000100001000000101001100101100100000100010010000010100010010001001011100000101000001001000001111
10000111010011000101010100100100010000000001001000101000010000001000010000000000101110011100000100110
10000001000101011110000100000100110000001111010000011011000011000110000011001010010000011110110000000
01000010010011000011000010000101000010010110000000001001011000010100110101110000000000000000010100000
00000100010000110000000000000000000000001000000001000101100001000001010000011000001010101000000000000
01011110111000001110000011000111010011100011110100000110100100000010100000100000100010001000000010000
00101001000101010000011011000101000000010101111000000000001001000011111001000100010000010000100000000
00001001000000000000101011110000001110101000000000000001010110100000000000000001001001110000000001100
10010100100000000000001100000000000000101010101001010101010010100000001110100000100001100000000000000
10010000110000000010001100010010110000100000001000000000010000000000100000000100000000000001011010000
01001000010100000001010110000010000001110001110010100100110010000000000010111010011000100000000000010
00010010001100000001000000011010000000000010000000101010000000000101110100010010100001000001010000001
01100010000011110000011000000100010000100000001001111000000000111000000010001101110110100000110001000
01001000101110010010000000000011110100000010010000000000000100001111001001100100010111110000001110010
11001011000000001001101010011100000001011000010000000000001001000000000000011010010000000000011000101
00001010000001000000000000101000000001010101000101010010000101000110000000000001100011001000000000000
00010000001000100110000110000011001000010111010001100000011000000000000000011111000101000000001000010
00010001000001100110110100100000100011001000001001001111010001000000010101001010010111000100000010010
10100000010100110010000111110000000100000010001111010010000011000000000010000000000101010100011000110
00000000100010001000001000000010100001000101101000010100010011000000000100000000111000010000000110001
00100000110000000000000000010100011000100100000100000011011101100000000100010001001000000000010000001
00000111000010001000010001100100100001001000111100001001110000001110001010101101101010000001001101110
01000111000000100001001000010000100010000001110001000010011000110001000100000011001000101101000000100
00001010101000000100010000100000100000001110001010010001000100001111100110100101010010100000100100100
00001000000000000000011110110001000001100100011000101000000000010000010001010101101010111010101000100
00010101001010001101110100011111000110001000010100010000000101000001001100101101010000000001000000000
01010000000000000010010000000000101000010011001000000000001100100010001110010010010001000001100000110
00010010010010001010001000010011001110000000100001000000000000100100000000101000010001010001000110010
10101100110110001000010000001111101100000011001010000100000110000000100010100101000110100001000111010
10100000001010000000000000001110001000110100000111100101000001101000000001000000000010100100001011001
10111000000010000110001111000100000100000001000000010001101100001001111011000000001011100001000001010
00101011010000000101001001000100000101100010101010001000110100000010100010000000000011011100011000101
00010100010100010101001101011011000000100100111000100011001011010001001101000010001010000100010010000
