01000001011000001000000000100000010010001001011010000110110000000110000010010000011001101010000100100
00010100000010000010110000000100000001000001010110111000110011000110000010000000010101100000100100000
00000011100000000110001111000010100001000110011100001010000011010000100000000000101010010000000100100
00001000101000001001100111000110000000010110010001100001011000010110101000000101101100000100001010000
10100001010110000000110000000000001000000100000100100010010001010100010000110000001000100100100110010
01001010100110010001000000001000100100000010000001010000100000001001100011110101001000100111000110011
10000100000010010001011000011011001000000100010001001001100110001111000010011010000000000001010100101
01001001100000011001011000000000000101000000001000100000000010000111110010000000000010100111101001100
01110000011010000000000000001101000110110001000010010010111000000110001000001000100000000000100101100
10100100010000001100000100000000000101001000000100011010111001010000010001100000110000000100000101011
01101000000010000000111100100110101101001001001000010000001100001000000101100010011000000000000110100
10100100000000001100000110100100010001000000000010100100001101000100000001100010100000010101001000000
10011110111010000000000010100010101001010000010000000100000011011000011010100001101011001110100100010
00001111000001000001011100000010010000000111011010001001100001000001001010000001000000011010100000010
11000110100000010011011101010000000100101100000000011111111000000011001010000100000101000010000000000
10101100000011000000100000000100000000100110001000000100011000010000000001100101000100001000100110000
10000001101010110010000000000110001101000000011000111111100000001100000011001001000100011000000110100
00110000011100010000000110000011000010001110000001000100001100000000110001100100000111000001000000100
00001011100010110010000001000100110100000000110101010011000111000010011000000110000000101000001001001
00000000001001001101000001000000000111000010101000101110001001010010000001000001100010100011101000000
00000010110001010010100111100000101000011101001001100101000000100100000010000010000001001000101000000
10000000100001010000100001110110000010001011000000001100110001000011000001100010010001011101100000010
00000000010000000001100001101111000100001000000001001001001011010011000100001001100110000010010010111
10001000001001010110011000110001110100110110101010010000000100001111101000001001010100100010000100110
00001000100101100101100000000000000100110000000001100010100100011000100000111000100110000001011100001
01000101000001101000001111101010110010001011111000000110011000010000000111110100010011000000010101000
01101110001001101011000110100001010001011100100000000000000100000000101000000000100001010100000000100
00000110010000000100010001000011100100001001100101010000000001010100100101000000010001100000000001001
11000110000100110100011100000010000010000000100100010011001101101100110001001100110101101010100000100
00010000000001000000000010000011000100001100100001000100010101001101000000100100010000100100000011011
10011001010000100101000011100101010110010111110000000000100000100110101011011010010000100100010000101
10011001001010010010000000011000000100010110000101010000000000000100000000101100010100010010000100000
00101001001000011000001001000000000011000000000000111000000001010001000001110110010000000000001000000
10010010010000001001000000010111000011001000001001000000000000000101000001001110000010000000000100000
00000000000010000101000111001010000000000001000001000001001000000000110100010110000000010101000000101
00000000000110000000011000110000000111010001000111001010001010000000100110000011110101000001001000001
00010101001000011001111001000000000000001100000011000000010101000101101000000001001010100001000000100
00100101100110100001010001000010000000100100000001000010000011101000000011000100010000001110001001000
01000001100000000001010001000010001011010000000010110010111001000110010000000011100000100010000000001
10111001010000100000011111000010000000011100001100100010000000000111011000001000001011000000000001000
00001010000001000110100100100100011010010100010000000010100100001000000000000000000011000010000010000
00001110001000010101100001011000011101000001000000101100010111000010000100000100010000010111100010010
00100010110000110100010111010100000010111010000010010000001011001000000011010110110000000010110000010
00000000000000000100000011001000000010001100010101110000011100000100100000000100011001000001100001100
10001110000000100101100001111010000101100100010000101001100001101000110001100010001100010000010101000
00101100100011110000001100010000000001011000101010010010000000001011001000001010100100010000000100010
11110000100110001010100100010000000101110000101000001010000001100110110010100010000010000000010000000
00000010000001001110111010000101000001110000001101011000010100000100100001010110001011000000000000001
11000010001100010010000010000100100011001000100001110000100110000111000001011100100001000001000000100
00000000000000000100110110100001000111001000010110101000001011000100110000000100000011000110100001001
01001000001101000100000010100010010000100110000100001110110110000110011010000000100000010100000001000
00000000100100001100000000100000101010100000000000011000000100101001011000111110000100010100010000001
00100000000000100100000100101010000110000100001001000011000100000100000100001001011100000000101100000
11000010100100100000001100110000100010011100000100010001010110001011101001000000000100100000011000000
10111000001000011010100000000000001110110010000000100100100001010100000001000100100010001000001100110
01001000000110101010001110001100011000101110111100101010010001101010100000001001100101101000010000101
00000010100001000010101000001100010011111001000101010100000100010001010001010000001111010111001000010
10000110000000000110001001000011010101001100110000011010110010100001000001011010011001011001101010000
00000010000100001000000101010101101101001111010100100111110000000000111010010000000101111000110001000
00000100010101101100000001001010101010101100100010011000110001001000000101000000000001000011010001010
00001110010111000001000000000001001010000001111000000001000000011010000110100000001100000000010000010
10000001000100000000000010001000000001100010000011000001001100001000010000001100010011001010000001000
01000000000000011101000100111100100000111100001000100100001000001110100000111011000000101010100000010
01000010000110101001000101000001000001010001000001100001011100100011000000100100000000101100000011000
11000001000010000010000001000000101001101000000000000000001000000010000001110000001010101000100010000
01100000000100100010011100010111011001000011000001101010010101101000001001100110101000010111100001100
00001010000011100000101101001101101001000000101101011001010010000000110010110000010000011000000000010
00000010110010000110010100000100001000100011111100001000100100000011000000000010000001001100001010100
11010010110011000000101001100001100000100000000100010001011111001000000110000010100010101110001000100
10011010011000010001111000110010000101011001000110110010000001000001010000000100000010010010111100011
11000010000001010000001000010100001100101000000111010001010001110000100100000000110100000010000000001
01100000000100001000010001010001010001000001000101001001110101011000011000010000010010100000110111110
11110000100001000000011011000000000000101000110001000000110000001100110001000001100000001000000000000
10010001000100100001100001100011100101001001011010000101100001110110011100001111110000000100110101001
00010111000100000010011110001000101011000000011010000000000000101010001010001011000010000000010100110
01100000010000010000100001100100010000000010000100000010101010100100100000100101100000011010001000011
01000001011100010111100000111001010000000101101001100001100000011000000010000000001111110100000000001
00000011000011100111010000000000001111000100000001010001100000000001101011001001010111001100000000000
00100011100000001100011100000100000000000010000110001110000000011100000001000100000000010000001010000
00110000101101100011000000011000000011011011000001110000100000000001010001001101010001101101000000100
10100000001010010000010011010010001100111011011100001100000000000100100100001011000000000000000000100
00000010100000010011101000100000000001111101000000001101111000100000000001010000000101001001000001000
00100110101000000110000000010000010000001000110010000011000010000101000000100010100100111111100110100
00100011011000101111011000001101000100001011000000011000100001010000100100110000001010000010001000000
10010000100011000000100100010000001000101100001100000010010001101001000000001000110110101000000011000
11001010001111001000010010000000010001111010001000000000110100011000010000001000011101000000010000001
00100000000001010000001100110000011110100011000100000000000011101000010001000010000000000000001101000
11010010100000011101101010001100100110101000011100101010000110001100010001000000010010011100000010000
00000100010000100111000000111110010100011101010010000101010000110000010100010000010001010100000000000
10001010111000000000100000000011000101111001101001011000111100000000110010000001000100010000100000001
00101101100111010010011101000001000001100100011100100001000110011001100000000110000000001010000100110
00100000000000100000111010000000001000000100011010001100100000101100000000100010010011100100000001110
00010000000000000000100000100000000000000000001001011010011011110000010110000000000100000111000101111
10000011011100000010100000011101010010101000000000010000000000010100000001010001011100001010000010001
11100000011010000000010000000001011000001000000000000001010011001001100101001001000010001110010011010
00000000110000010100011110111101001010000100001010001000101000000010100000000000010110101100110000100
00010100101000000011111000010000001001111101000000100010001100110000000100010001010000011000010100000
10110010100010100001000000000001100100001100110000011010101101100100101000000011010001000011001100110
01001000001111110100100010000100001000000100000111000000010000000001001110000110110110010101000000010
00000000001000000101010111001011010010000000000000100001000101000000000111000000011100000001110101010
00110001110000101100110011010000000001100001010010001101010000001101000001000000010000100000100010110
