01101000010100110100001101000101110110000010100000000010110000100110101110101101000000000111100000001
00001010101100100010100000000100000010000000100000100010010111001000110110001000101000001001011100000
01100000000010001000000010000001000100110010000001010010011100000010010000000010001000000011111100001
00110100011000100100011000000000100101100000000000010001010000000000110010100110000010000000100001000
01000010000001000011000110001000100000100000100000000001100100000100100001100101011000100100000000000
01110001100010000001110000000010100001001110000010010000100100000010100100110000100101110001000011000
11000010100010011001000110000100010000101011100000000100010000101101100000000010111001001000100000111
00001100100000111110110011000000100101000101000000110100001010000001010000000000000001000000000110000
10100001001101000001000001011100001110100101101010000010000000010000000111001001100111100001100011101
01000000001100100101000111010001010110100100010000000100001011001001110000000100001000110001010000000
10000000000010000001101000000000001000000000000011100010000001000000010000011000010100110100000000000
00100000100000111001010100010110110000100001011000000100010010100001001100001101000010011110000000000
00110010010101101000101100010000100000101000000000100011010010111010010010010000001011011001000001100
01000000101110001001001010010001100101001011001000000000000100001010100010000001000010100000111101000
00011010011010100010000100000010000100010000010100001000000000000010101100100000101011010101000000000
01100000100001000110011001000010110100101000000010010000101000000010000111101000010000110100000000101
00101001000000011000100000011100011100011100101011011000001100001000100101100000001111000000100000110
00110010101000000010111010100010001000000011001110000101001010001001010001100100000111110011000000100
10010010010000100101010100100010000000000100010010000000010001100111100110010000000001000000101101000
00000110011100000001000000000100000000000000010000000010010111001010000100100010100000001001000000000
00000001000011000100100101001000001011100000010100001100011000001000000010100100000000001110000010100
10000000000100010001100110000100101010000100000100011101010000100000110100001000010011000100001101000
00000001100010010110000011001001010000000100000001100001000000000001100000010010010000010011101010000
00011101000001110001111000000000000000100010100110000000001101000001100000001001000000000001110101110
01101000100010001000000000100101011100010011001000000001000010000000010011010100110000001110011000100
01010111100101000000100100011010010000010000010000110000110001000001000100001110000000001000100000000
00000101100000000000010001010000101000001000010000010101000010000000010010100000000000100110010001110
00000010010100000100000000000101010100000010111010000110000010001100010001110000000100011000001100110
00000101000000000100000001000000000000110100000000011000000000100000100110000000000010001000010100000
00100010001111000000000000000100000010010010001000001011000000000010110101011000000010111000010001010
00111011011000000100000000110111100000001010000000110100010110010010001000110000001010000000010111000
10000000000110010010010110010011000001001100010000001001110111110000001110000101010000000010000010001
00001000000010100000011100000100100010000001100110000000001110100001001000000000100001001011000100011
01110100100000101010010101010111100001000110110001110100101100100001010010000000110000101100000000100
00001000001001010000001101000010001000001100000000000000000010100100001001010111101100101001101100110
00000101010011000011000001011010000000101000010101110000000010100001100001001000010101010000000001010
00101001101001000001100000010000000000001100001000000010000000010110000011100100010101000000001000000
00110110001000110100010100001001101010001011000001001100000100000000101100000000000100111101100100100
01000000000000100000111000000100000000000111011000001010011011010100000010100001000010001100000000010
00010101100101011010000110000000000010010111010011000001111010010001000001001000101000111001100100000
10010001000000000101101000010001011000000001000000000000001001000000000000101000000000000010110010001
00010000001001000000100001010110011000010010110000110110000000101110010010100110000000011100000000000
01000100011000000101000000100100000000000010001000000000000000011000001100100100100000001010100110001
00001000101001011000011010010001000100100111000001001001000100010110001100011000111000000100001000011
00010010010111100101000010100000100000100000010000010000000000001100010110000000110000001000000011010
00110110010000000000000010100010111000000000010010010000100000000000010001111100000001100010000110111
01011000100010100000001000000000010010010010100011010100000000000001100001010001100010000000000001001
00000000100001000000000000100000000110000101000100010101010001001010011001000100010000010011010100000
00000000000000000011001110001100010011010000000010100101000000100001000000110001100010000000010101111
00000011000010001000001000000100001011101001001010011100001001111010100000010000000000000010010000101
10011000001100000001100010101101001101101100101010110000110000001000010101110100100101010110011100000
10011110110000100010001110001100000100100100011000000000111010011101000111000001110010010000010000101
10100010001101010001110111011001100000010001001011011101110000010001010001001110101100010000000001010
00100001101110000010001011001000101110100010100100100110100100010110001000101100001000000001010000011
00100001000011001100110000001000000101111110010010000011000000111010111000001000001010000000101001011
11010111100001011000010111100001101001010000010000000000000011000110010011100010010000000000000000001
00000010011010000100010101000101010001000100101000000100100101010101001001100000100100010010001001010
10100000000100000000000101000001000101111000001100111000001001011000100110000000000100101000001001010
00100010010010000111010001010010101010100011001010001000010101001000001100000101110010101101010110110
00000101101111100010000011000110000010000010000101000000010101000000101010001101010010100000010000101
11011011000100100000010101100100000000010000110000001100010000010100000011100100000001100001000000010
01000100100001000000010100000000001001110010110000110000101000001000001000000000100101001000000000110
00011111000000001001100101100000010100010011011000010110101001001000000000000011000000010000100000011
00011100000101010100100010010110001101001010110001000100000000000110010001010110001000100000010000111
01010000010100001000000101100001100011000000001100001000010001000110100100010001000101000100100000001
10101000010100001000101001110000110010000000100000000100000001100011000100000000100000000101010000000
00110010000001000011100110001100001011011101000110100110000000101000000010100101000100001000100101000
01010000010001000100001011000000000000001000100000100010001101010000010000001010001000000101100000110
11000000000000000000101011000001001010000110000000100010001001010000000000010001000100010000001001000
00000000000000110010000000100000100101001110000101100010001110001100011010000010000011000010100000001
00010011000101100000110110001001000100111011011010110010100100101001000000110001001100011001100110000
10010000100001110010100001111000000001101100000010000100000001001000001000001001000100101000000010000
00111011000100000010000011010001110000100000001100101010000100010010000000010001000100000011100000000
10011000000000000000000000000000000000101100000100000000000000100010010100000000000000001011000100000
00101101000001100000000001110000101000101111100000010000010000010001010001000000100011001100011001000
10001000000010010100000010101100000000100001000110000000010011100100010000000001010010110001100010000
01000101010110000011100000000001100100100001000011000101110010000000100101100111000100101110101001000
00111000110110101010000010001000010111001011000000001100100000000001000000100000100001010000110100010
00000010001001110101010001000100000000011001011000010000100100010010101001001000000011001000000010001
00011010100010001000001010010110100110100000001000001000010010011000001001001000000001000011000000101
00000100011100010001100000010000100000000100000000000010111111000011101000000100000000000100010000100
00110000010010000000001011001000111001000001010000000001001010000001110110101001000100111000100010110
00000000010101100110000101001000000000110011100001101101001011101001010100100010000100100000100000000
01100000100100011010000111011010000110101000000000000110000110000010000110001100000010110100101000000
10011110000100010100101000110001101100010001100010010000100110001010101000000100001010001000001000000
00000000100000000000000000000000110010001010000000101000001100100001000000100001000010100000010100100
00101001000100011001101101000010000000100011000000000000000001001010010000111000001001000001001001100
11000001110000100101101000010000100011000000000000001000000001000100100000100100000010000111001001001
00010000000000111010000001110111001010000000000001000010000000010101010010110000001000010110000000010
11001101011000000111100010001000001000001010001000100000000000000000000001000000101000000000000010101
00010000000010111100100000000000011000000100000000110000100010000000000011000000110100000000100000000
01100000101100100101001000101001101011001101111101000000001001101001001100011110100001011100010101010
00000000001100110101101100000110010000010000100000001100100000000010100101000001000000110001001010011
01101110000001011011100110000000001010010100011100010001011000011100000000000010000010100100010000110
11000101010000000000000100000000010000101000001001100111000000001000100000001000000000000000001100000
00010010000000000100100000001100010000011000010001001100010110010100011010000010001101001010001110001
00110001000001100100000000000110010100000001000010001000000100000000100001001110000000010000110001010
00010000001100110010010000000110101100000100000000000000000010000110010110000000000000101000010001000
00001000001010001001110111000010001000001011000111000000110000100011000000000101000000101101101100100
10101000000110101100000000101000000010000000000000010100000000000100011001000010100000110011100100000
01000000000001110100010100000010100100000100100100000110000000010100110001100010000010111000000001000
