00100001010000000000000100111000101001111101001000000101000000100000001100100101000010100000111000010
10000010101110010101010010100000001011000000111010101000100010000101000110000000000011011110000010001
10000010010000000110001001000100010100010011001001100000010100000110100001010010101000010001100011000
00001111000101010010100101110000100001110010000000000010000010000010000001101000000100000100101010011
10010011000010100101000100010100001000000101000100000000100000111000000001100100010001100000101011011
00010100001000000000001000000100110100000000011100010101100001010110000000100000010000110111000010100
00000110000001101111000000010000000101000000000100000100110000100001000011000001000111100100000001000
10100000001010010010001000110001000001000111110001010000000101001000011010010000010001000000100011001
01001101001111000000111010011100000110010000010000010010011100010100100110110000000000000000001000001
00000001000001000011001001000001000000000010000000000000000000001000100000000000001101000010000000001
10100000000010000000001000000111100111000110100010000000100000100010100000101010001000110001110011001
00011010001000000000011010000000100000000000001010000000010111100010110110001000010010011001000011010
01001100000100001011000001000010000100001000010010000000100000100001011000001010000100000000000101000
00100000111001111000010000000000100101000000000010011011001101101011100100000000010101000000000100100
01000111100100010000011001001000001000100011100101001010000000000000111100000010000101000001000101001
00100000100000100010000101011001000001010000100000000011110001001000100010010010001011110010001000001
10011001000000010000010000100010100000000100101001010011001110000010000010000000000000100010100000000
00101000000100000010011000110000000010111110001101000000000000000100101001110011100001000101000101011
00100110000100000000000001000000010000100100000110000011010100000000100010101000011010011010010110000
01000010010011111011100001001000111100010100000100111000010001010000100000010100010000100000011000001
10001101000000110011011010100001100010110100111000001001000000000100000100010001000001100000010000100
11000000100000000001010001011000001010100001001000110000000100000000000000001000100001000101000000011
00001110010100000000110000010000100101000010001100000100110101101100101000100100000100001001100000000
01001010011101100111000110001100001000011101001101110100001001100000001000000000000100001000000000001
10011100000010111000011000000000010000001000100010010000001000100100000000100100011010100110001001001
00000001111010001010010000000100000100100000011101001000000000000000110101010001000110101000000001010
00001000001010001001001100010001001101111101000011011010100000000001001111101010010000100100001100110
00010101000100010001010011000000001000000000110010100000100000000000111010010000010001100110010001000
01100000011100000000000000000001010010000100000011100110011000100001111100000100010000100110000100111
01010101001010011100000100000000000101111000010011001101000000001001000000010101100100010101100000011
00001001000000010010000000011000010001000010000000000110001000000010001001010001000110000011000010000
10000001100101110001001010100010010000100001001100001011000000010100100100000000000110100000100000001
10100000000110000100001100011000000010000000010001101100001000101000011010100100001100000110000001001
10001000001000000001001100100001010001010010101010010000100010110011000110110110100010001011100100110
00000001001110010001001000100100001010111100000000100010101111000000111000100001000100010000100000100
00000100001010010100000000010110010000000110100110100111001001000000000010000010110010000100000000000
10010100010100110100100110000000001101110100010000010001100001100010000100000000000010000001100010001
10001110001000100000100101101100000001100000010000000010000100100000101101010000011111000101100000001
00000001000000100001011000001000110001010110011001100100101000010001000100101000001001000000000000000
11000000000101101010000011000000010101100100101001000000101011100011000010101010011000010000000001000
00000100000011000010011000010000001111010000001110000100101011010010000010001001001101110100101001010
10001111110010000000101001010000000000010000000010010100110010100001010110000111000100000110001000101
00010000100110101100000110000000000100101000011000001101001110001101000100100000000001100010100001101
01010010000000001000001000100000111100010010000000010000110110000000000001000000001101000000100101000
01100001000001000100010011001000100010000100010000000000000000100000100000001001011100000100001101000
00000100011000001010010011110100001000100010100000000100000000100110100001010000101000010000111111010
00001000000001001001100000000101001001011100100110100000001001010100011100001000011000000110000010010
01110000011000000011101000010111100010100000010000001000001010000111010000011101100010000000010000000
10011000100100111000000011001000001001000001111010101001010010110010101000000001100010001000100111000
00000100001111000101001001001100011000000000010011001000100101001001010000101100101100100110111000100
10011101001111001110010001001000000111101101000001011010001010000000101010001001000000000000100001010
10100111000000010001100011000010111000101000000010001110011000100110000001010010001000110001000100111
00000001000001000000011000100010001010011010000011000110111110000011100000001110110100000010000000000
01010100000000001110000100010010001010000000000100001100000011111000100001000101000000000001001111011
00111000100000000010010100010000000001100000000100110110110100101001000000010010001100001001011001000
10001000010001011010000011011000001101000111001110011001000000100111110100010000010000000010000001000
00001100010010000100100010111000010101000100001110100000000010000110100010101010010101001011001010000
10010001101001111010100111000101100011100000110000001000000010000010110001000010001011111000000000000
10000000000001000101110000000001010100000000000010010000000000000010100010000010011000100100001010000
01010100000100001000100000000110000010000000101001000100000110011010000001001010111000000000000011010
01010010000101000000001011100111101100000000000000111100100010010010000100011111000000000101000000000
00101110000000100000101001000010100100100001000001111010010101001011000001000100000000001101000011101
00000010010000000000010101000000001000000001010000010000100000000011001110010111100100001001101101010
10110100010000000000010000000000000110101101001010111010101000001100000101010001000000000000110010011
01000010000001000101001110000100100011000000001000001010000000011000011000111000000011000010010100110
00100000000001000000110000000101010010000000001011100110010000001000000000000111110000000010000000010
00000001000010100000101001000100100001001011000000010001000010000001101000000100001000111110100000000
00101010000001000011010100000010001110000001100010111100000010000000000000000100100001010010011010101
00010000000001001000100010000100010000100000000100000000001000011010010100100010101010000010000001001
10100000000000010011000111001110000000110100001000000000000000010101101001110100010011000000010101011
01010000100011100001000001000000000010101000100100100000111000101010000000000110000000001010000011000
00000010100010111000010010100100010101000111101100000101100010000000010100000000001010010001000001010
11000101000010000100001000111100001000100001000110001110000000001001000001000110000100011010000110001
01111010100100001101000000110001101001100111100010000000010000000001011010101001000000100001000000111
00001000110000100000000000111001000000000111100101001110011100000101001011010001000101010011100010000
00111010010010100110000000100010100100000000011001011010000100010000010000000001010110110011110010100
11000110010000000111100000000000100000000110011000000110000110010010000010101000000000100001000000000
11001100100001000101000000010010010101100000010010011010101000100001010010000100000110000110000010000
11000000000001100100000000011001001001010001011101101101000010000010001010000000010000000000001010111
00010000101001010010100001110100011010010000000000001011000010110000001101000010100011001000010101010
10110000011100001001001001010111000100000011100001000000011010000010000111001000000001000000110010100
00000110011110010001100001001000100001000000001000001000000001100010001000001100000000100010001100000
01011001001011011001010101000011000010000100010000000000101100100000000000110000010000000000000000010
00100000000000101101001110000111010010111110000011000011001100100001000000100110000100001101110000110
10000110000001100011010110000001101000101001100000000010001000001000001100011100000000000001010111101
11100001000001000101111100100110000110000010101100000000001011101010011000000000000001001000000100011
01010001000001000100001010011001010001010000000000010001001000100000000010001000100001100000000000000
00000100000101000101000000000000000010001000001010101001000000000010010010000000001001011000001000000
10100000000010001000101010100000101001000101001010010001010011110001001010000100000010110100111101000
00010000000000100000001001100010010100100010000010110000101000100010100001000101000100110111010000010
00010000011000000000110000001000001100101100011100001101111010000011000000110001010001011000110000000
00011000110101100000100100010000000100010101000100000001000100000100010100000010101100011101000001100
11000001000110010101100010001000010100100100000001001000010000101000001000010100100100011000000101001
00000011001001001000000101001000010010000101100110000110000011101000001000001000001000010100100011101
00000001001111100001000000100100000000000011010000000011010111001001010001110100000000100000011000011
01010000001000101001001011100000100000001000001001011001100000110111011000000001100011000000000010000
00000001000000001000000101000011000101010101111001000010000000010000101001101000110000010000111000100
00000001001100011101101100101010001010010001110001000000100001110101000000001100100010010001110011101
11100100010010000100000010110101110010010001101010101000000000000100000010010001010010000011101000000
00001001001000110001100001101001110010000001100011100111010011100010000100100010000010000000000000011
00000000000000010000010010000111110100000001000000001000010100100100000001100111111100111100000100000
