00000001000001100000100100100000001011111100010000000011100110101000100000000100010101000110000000010
00001100001010001010000001100000000000000111010001000000000000000001000100100111000000110000000010010
00000001000100100010000010010000010000000101000000000101001011010001100010000000000110100110010010010
01110100010110110000000110001000000000000010010111100010010100110001010101011001010011100000000110101
00000100110101010001001010010100000000011100111001000101000100100000000011111001000010001001001100110
01001000011001010110000110000100000010110000001101001110100000001000000000100110011000000000001010000
10010010100000010000110000111000001000011000100001000010111000010000001011011010110000011100010000100
10000001001010010100100011001000000100000000100000000000101000010111001100000000001111000000100000000
10000001001010010001100111000000010000100110100010100010100011010101001010000001001101011000110110010
00110001000000000010000011100000000101010010000101001010000010000010001100101000110100000100000100100
00001001001000000010001000000010000000010100000010100010100001001010110010110101000000100000011001100
00001101100110000010110010001010101011100011010101101000000001010010110000010010100000000101000100000
10001000010000101111000000001000000111001101000100100010000010001000010010100100101000000110100000110
01010110000010001001000001000100010001010010000000000001100010110010000100000110011011000011000100000
00001011111000001101010100110001101010010000000001010001000000010001111100001101100101100110000001101
10101101000011001000000000100111010010011001101000001100110001001010011000011110000000000010000011000
00000001000010101000000001100110000000000000001000000101000010000000000110100010000000000110100000000
00000010100011001110010010101000100001000000110001011010010000000001110000010000010100001000000001111
00000000000000000110010010010000100011000000010100000100110101000101100001010110000000110010111000010
10010000000010001001000000001100100000000100011010111000000100010000100000001011001001111000000010011
00010000101101000001000000011011100100000111001000000101000100000000001001100000001101000000011000111
00111100001000100110101000000000001110001001000000010101101001001000100100010001000100110010100000010
01010000001001000001101100110000001000000101001100101000101100101001010000010001000011000001001001000
10110000000111100000101100000000000010010010000000000100101011001000000010000101100100000100010111000
01001110010010010101010000000000110101101111000001000100011010011000001000001101000010000010100000000
10010010111011010001000100101001010011011100000000110000000001001110010001000100010000010100000100010
00000000000000110100000010000000011011001001100010000010000010100100010011001100000100000110111001110
00001100100000101010100001000011000010010000001000001100000100000010100001001001010101000010011101101
00000010000010000000000000001111000001011100010100000010100000010100100000000110011010001000000001000
00001101000001010000110100001010010110001000000011100100000000110000110000110011000000100000011111010
10000000000100000100000000010001001011001000001110011010000010101010010000010010001111001100001111011
11110000000101010000100110000010001001011000110000000010100000001000100111110001110010001000101100100
00001000000010000000101001110010001110000000101000001000000011001101000000000000000100001100000010001
00101000000100000000001000011011001000000000000001000000000000100010000000010100001010000010010000000
00011001001110011011110000101100000010010101100110010000000000000000100000000110110011001000010101100
00000110101010101000010000000100000000010100000100000000001000100011000110000000001010100000000000000
10010001000000000000000001011010100001010000100011000000011100110100000100001000000010100000010010000
00110000100010001001100000000000100001000100100010001011110000100000010001010001010111101000000111001
00010010101100100000001000100001001010101000101010001001011010001001110000100100000001100010010100000
10000001100100110100000110100000100010110000010000001000100011001010010011000000110011000000000101100
01000110000100010010000010101100001000000110000110010000010100110000000100001010100010010010000000010
00000110010101000100000010010001000001100100011100010000110000001000110010001010011100101010000110000
11010010000011000000000111101010000001010000100011010100001001000000000000000100100000001010011001001
01001001001000000100010001001000000100000000000000000010011110000010000110001100001100000010100010000
00000110000000001001001001000001000011000011100001101111101001001010100000110100000100101100110110001
01001100000000110000110100101111011000100000000000010001001010000100000001000100000000000000010100100
00101010001010010100001000010010011000010101001100110100110010110001011000011000000100110000110000010
10000000000011000100011000010000011100100101001010000100000101001010000000000100011110000101100100001
00010110000011000010100100000000000000000001001001000000000100000100001011110100000101010000100001110
10000001010010111010100001000001010010011001000000001100000010010000010000010100000010011000000000100
10100100111001011010011000000000100001000000000110001101111110101100010001000000101000111010101100101
10101000110101001000000000001100101000000000100000001101011111100010010100000101011001011110010100000
00010100001011100000100101000010001001101110000001000010100101001000000000011000100010000011101010000
00100000010100000000000010000101100011010000100000001010010000001100111010011000100001010110000001011
00001000100000001110000000101111000010000010010010010101000000000010000000000101011011010100100000000
10001110100001000000000100100101101100000000100000001000100001110010110001000000000010000110001100000
11000100000000000000111000001000100010000111000100100100000010001010000001010000000110110100110011010
10000100010100010101000010101001000001100000110001000010000010001100000000000100100000101100101000001
00001001000001111000001111000000111000111101010000100000001000100100000010001000111001010011000010001
00101010000000010110110100010010000001000000101001000000001111000100010101001000000000000011001100011
11111001001100111101000110100000000110101011001000000100010001110100010000001011110001001110010010001
01000011000000011111100011010100000000000100001100110000011000001000000011000100000000010110011011000
11000001100000001110010010001001000001000000110000000000100000010011111001001001001000010010100010001
11000000011111100010001010000100101000000111000000001000011010001000001000000010000000000100000101000
00101000110010100001001001010001100100110000100110100000000000010100000000011000000001000000100100010
11100011001000100001010111000000001100000100011100000100011100010000000010101000010011000001101000001
00000101001110001000100001000001001010000000000100011100000000000000000101000001010000101100000001000
00010000100010000011010100001000101010000001110000010010001000000100010110000000001011110001010000010
01011010101010010100111000000010010010010000001100000010100000000001010100100010000000001000000110001
10000011100010000100100001000101000100000000001000000010101101101010001100000111000001000010100000000
00001010010001011011011001001110010000100010100000101100000011000001011000100000001000001100100100000
00100000001000100000100100010010101101100001110010100000000000100011000001100000001001100001000010000
10001000101001101000000100000010100001010100000011000000010000010000000000010110000011010111010010000
01100101000000000100000001101000100000001000101001001110010100100111011001001001000101101000011010100
00010001010010001100000000100101001100111100000111100010010001100000111000010100011000000011100000001
01001100010000011100111010000110000010001000011010001001001100000000110000000000010110000100010011101
01001010101000001100010101010100100000000101010010011001000000000000011101001000110001010000101100101
00100001010000000010010101100110010000110011110000000101000100000010001000100010001100000000000010001
01000001001000010100010101000000100010000001101011000100001001011011011000000001010000000100000010110
00111000010011001100000100100000000000010001000010100000010101001100000000100100110010001000101100100
00001011000101000110100000011000000011000001000100000010000100001010000001001001010000000000100010100
00011000000000010001111000000000101001101010110000000000001101011010011010000010100001000000100010000
00000000010100000100010110100101001110000100100010110000000010101010000101001110001001010100110001101
11001100000011001000000000000000001001100001000010001110010001100110000001111001111010100100000010000
01010001010111011110100000000000011010100100010100000110000001000000000001100001000101000010111000010
00010000001100100010000000001110100110100001110000110010000000000000110110110000100110101110011110011
00111100101001010010011010000000100000001011001101001011101011001100100001000010000010001000000100101
01000100011011000001001100100010011001000101010011101010000010010000000010110110100001110100000111110
10001000111010001111000000001101110010000000000010000101001001000101100000000100000110101000100001000
00100010010111001000000100000000101100100010001100100100000101000010001000011110001000100000010001000
01000000001010000001010100001010001110010000110000101000110110100110000000010111100010000001000000000
00010000000000101100110100010010100101000010101001010100110110000010000000100001101000000001000001000
01000001011000101100010010000001000001100101001010000000000000100010001011100000000000001000001001111
00000101100000000000000001000010001010100110010010100010000000011001000001000100100101111100000000101
00000000110001110000000001011000010100010000011100010100001100110010001011000010100011000010100110100
00000010010000010000110000000100000010000000000101010010111010001000000000000001101010100100011001001
00101101111000000010001100000001000100000000100101000010000001110001000110000010000001011110101000000
01001100001010001110000001001000001010000001011000010011001000100000000101010100011010000110010100010
11101011011000110010000001000000010110000000000011100100001010101000000100010001001000100001000010001
01101100001001000011111010100001000011000000010011000010000110010000000000000110000000001100100000100
00000001000111000111110110100001000101110000000000010101010010001000101011001000101110101100010000000
