01000000000011100100000000000010010010110100000100100010000000000000111011000010000000100001101001001
10000011001101100001000100100000110000101100010010000110100000010010000100001000010101000010000001000
00100010010100010100000000000111000001110001000000000000111010000010110001011010011110001000101100010
10000001000001010001110000000110011110101010000100010010010000010001000010000000101010001111000100100
00000000100000100000001000000000000001010000000010001000000000110100010101010010010000000000000001000
00010110100000001011010001100100001010111100000100000001110000001010101000100011101110010101100000100
00100000010101000010000001100000000110000100001000000000100011000001101010101100000101100010000101101
11100000000000000000000000100111010010011000010000010111100001000010101000011000000000010100101101000
00010000011000111100010110000011001011000001000111000000001011001110010010000010000011100101110100101
01100000100000100000010000010100000000000010000001101000001001001100000000100100001000111000000000001
00000000000010010010000001000010000010100010100010001000000010010000001100010010000000011011000100100
00100001001100000000010100110000101000000101000101011001010101110100100000000110000000100010110100001
00100001011101000001000000001000010000100000100011010000100100011000100101100100011100010111100110010
10000000011001010000000101001100000000000000000000000010100101001000000010100000001001010100001110000
10001010001011001100110100000000000000001100100110101001010001000110111001010001110101000110010000110
11000000000010101011010110010000000010000000010001100001001000101011010000001100010010001001001100001
01000000000000111001001100010001000010000000100010101111001000000011010011100011000100010000011000110
00110011011000001000001100110110000000000010001001011001100001110101001010010110001000000000001001011
01001010100000010110100000000000001001000011000110001001000010000000100000100110001110000010000111100
10100111010010011010110011000000010010001110010110100000100000000000000100011000000000000111001011000
10111000000011011000010101011000101000100000101010100000110100101001100001100001101110000100000000101
10111000101011000010000000011010000001011010100000010100001000011000000000100011000000010010100110111
10010010000001000000001010010011000111110100001010000010101100001010000001011000100000000001010001000
01110011000011010100001110000001100100100110000100000100011001000000010001000001100100000000010000011
01001011100001000000111010000010101010110010100010100010001001000000000011000010110010010001100110010
11000110011110101001101000101000100011000010000001010000000001001100000100000001101010001001001000000
00000000000000000111010010000010001001000111001100010000000010010001001011000001000000011001000100011
11000101001001000000000010001101101110010110001010100100000000001100011000101000000000111101001000000
01000100100101100101110000001000111000000011000101000110010001010000000110100100101011000000001010000
10100010110000111010010000110000000100000000001000001000000000000100010011100100010101100110010000111
10000011000010000000110101110010000110000100110000100000000001010000010010010001100000010000101110000
10100000010000001001001001000001100000111100001010000000000000000000000100001000011100000100100010011
01001010000011001010010110100010001010100001001100001000100100010000010010000000011110010001111000001
00100000001100000010010001000101010100000000000010011010010000001000111100111101101001010000000000111
01000010110101010011000010010100110000001001000010111001000001010011110100010001100000000000100000111
01100001011000110000000010100001100000010000010001001000001001100010100000100100011001000101000110001
01100100000011101110000010000000100000010010000010000000000101100010111000000100110011110010000011000
10000011000001010010101011010000011000000010000011001000100010000000100000110000000000010000010010001
00110101000001000010110000001000000011000000100001000111000100101001110000100000111000110010111000100
10100000010000111110100001111000101100101010110011000100100100010010111100000100000001010100010010010
01000000100100001100010000100000000110010000000000000000010000010000110001100100000000001010000001001
00000111000010000100000001100000000101010000000101010000010000100000101001000110101011000000100010000
00000000001010000010100001010010011110010000000100000011011010000001010000000000011111101000100001000
00001000010000000000000000100010100011000100110000001001101000100010100100100010011100100100000001000
01000010101010010110000001000101011000000010110000100100001011000000110000001100100001011101000000000
00001010011000100000010001110110110010100100000010000000000011010001011001001110000010100111000000000
01010100100000010001000110010110100011001001000000001101100111001010001000000010110000100100010000100
01001101000101000011100000001010100000011001110100100100101001001000000111010010001010000100100001001
00101000101010001100110000000010011000100000000000100001000000101000000000000001000000110000000100001
10001001110010010100110000000100000001000100010000000001010000001000100000001000000100000000110001101
00011101000100010010000000001101100011000000101001010000101010000001101000001110000000100010000001010
00010100010000001010001111111100001000000010100000001100000000001110010000010101000000000100001100111
11110111000010101000000000000000100000000110101011101100000001000010010100110000001000011000000000000
00001100101000101000001000000000001011110000000001110010100100001000010001001001001100100100000000000
00100000010011000011010100100001101001000011001010011011100011100010110010000010000000100000000010000
10000110110010000000101000000010000000100001000001000000100000000110110010001000000101010100010000010
10010100000000101010100001011101010101001001001101000010000000000001000110100000101100010000010101000
00010010100000110000000010000011000001001001001000100110010100000010100000001000000000100010100110000
10110100001011000000000100001100010100000011001000000000110001000101000110100000011100011010001011011
00011011000101001001101110000001010011000010111010000000010000001100101000000010000000010011010000100
10000000010001000000000000100110000100100100111001100001110000100100000010010101001001101001011101000
10000110010011010001100100100011000110011001000100000000001000000001000000000000001001000001000100001
01000000011001010100001110000000011111101011011011011100110000001000000000001000000000010001000010010
10100110001100000010110010001101010001010010000000000000000100001001000101000000000101100000100010100
01100001010100010000001011001000100001010000010100010101000000010000111010010110111010000000100101000
00010011000010000110100000000000000001111000000001001000000010000110000000010001000101100111001000000
00001100000001001110001111010100010010000001101000010001010001110000100100110000100011000000000001001
00100100000110000110000000000001011000000100001000001000110001010000101011001000100010001010001000001
01000001000000000000000000001000100111010101011000000000000101000010010000100001100100011000100110000
00101000001000011110010001011001000001001000100110100000000100000010100001010000100010000000010110010
01110100000000110110110011100010011000111010100010000110000100010000101101000001110000101001100100100
00000010010111000000000101110010010010001010000001100001101100010000001000100001000000010010001010000
01000100011000010111010001001001000110001001011000000000010111010001011010001000000001100001000000010
00100010010000010100000000010010101101101000000011100100000000101100000110011000000101001100000001000
11100000100010011001010000000001001000000110000000100000000100101110101000011100101101100001010110110
00000010000110010101010000101111000001100100010110000000000010001000000000000000000001000110001001000
00011101010011000100100100000000000011001100010110011001100000001100100100000111001010000001011000000
00110010100010001000010101010010101001011001110001010010011000010010010000000000000110100010010000101
00100100000011001010101000100010001011010000010101100011010001000110000010000001100000000000000000011
00111010010001100011010100010001011000011100011000001001001100000110000010011000000001010101100001000
00010000000011010000001001010101110011101000001000111100100100010110000100100000111111100011001101000
00000001010010000100000001001100010101000011000010100010001100101101100000001100010100000100001001011
00100001010000100000011100000000110100010010100000000000001110000000100010000101001101011010000011001
00111001100000110100000000110010101101000011100011001000100010010000111100011000010101101010000010111
00110101001110000000000011011000000010001100110001000011011000100001000111000000000000010000101100000
10101000010000000000000000101001100010101101011001000001010100110001001010100000100000010100000000100
10001000100000000000000101110011010010010111000001000111000100010100000000001001011001001001010100001
00100010000001000000110000000001110100000010010000000000000000010000001011100010000001000100010010010
01000010001000000011010000110001000111010010000010000100000001000100000000110111000001000001000001100
00001000000000001000100000000000100100011010001010000000010000010010000100000000000100000010100000000
00000101001100011010001000101000100000010001001001001111000000000000000100101110100010000101011010101
10000000010000000010001001101001000000001000000110010010111000000000010111010100000000100001010000001
00000000111100000111010000110100000000100110000100000001001100010010010100100000100010000110100001110
00000000000110100100101001000100001010010011001000000000111101001110010000000110001010101000000000100
10000000000110100001110010000001011000011100100010101110000001011100100101001111000010010110000001100
00001000110100001010010000000010110100000000001010000000110101100011011000000001100000001100000000001
00000101001101000000001010000001110100001010011010000100101000001100000000000100110100000000010000110
01000000000011010000111110010100010010101000000100110100011100001000000001010100011011101100000100100
10100001000000000010000001000000100000001100100001000100000000100000011010100000000010000000010101000
00001011000110000100100001001010001011010001001011000000001000000100001001010100100011000101010101010
01000001110000110110101010100000101000000100000111110000000111010000100000100000000101001100010110000
