01000001001000001101101000001001001001000010000010000001010000000110000100000100100000001000000000001
00100010000000011011000001100001011010001001001110110000000001011110111010010000010000000010001000000
00000010000010100000001000000000001000000000111101000010110001100011000000110001010100001001000110000
00000100011100111000000010000000010000101000001000000111000101001001010100000000000010101000001000010
10001101000011000001010001000010101000100100000000000100111011011110010101001001000101001100000011001
00010010001010010100000000010101010000110001100000110001001001001000000000000000100000101100010011100
01001010000000000000011100101000001010000110000011101110100001111001000010000000001100110000000010010
10000100010000101000111100100000100010001000001000111001000000000000001000000000000000001011111000001
00001010011000011000011001000010100000010110000011000000111010000100001000001000001010010000100110001
00000010000000001001011000001001100100001000010010100000010000100101100001110001101001001110010101000
01101010011001111010000001001000010100100000011110000000100011111010011000101000001000001011001101000
10001111101000010000011000000010000000001101001001111110110000101010001010000010001000010001000000100
00010000000101100001100000011000000000000110010000011001000000110000000000001000000100001010000000010
10100000110000000010100010000010100101100000000011101011010111000010000101000000010000000100111111100
00010101000100000000000000001011101000001000111010110100001100000000000100110000000000000001010011000
00001000010110010100000001000001110000111000100110001000000001010000100101010001000001100010100001010
01100100001000110001001010001001000000010000000000001100110010000101001010011010000001011001011100010
11010111001000001000111010100100100100101000010001110000000001110000001001000000000000000000100100110
00110110100110011011000001010000100111000011011010010001010100000000100000011000000100001001011001001
00000010010100001101000000111110100010110001001110010011010011001100010011001000000001100100100000100
10111001100000010111110000010001110000101110100111010000011010010000000001011010011010000100000100000
00000100000000001001001001101010001000000010110010110001000001001000110010000001001010010110010000000
01100010000110001100010111101100010000110110100001010010000000001011000010101001010000100000010101000
11110010010111000001111000000000000001000100010011010001100101000100000101011000111000001001111010100
11010000110001110101010001000110100010101000101001011100111000000010011100100000011010000100100000000
10010010100001000101000000100000000010010010000110010011100101000100010001000001111101001011000000001
10101000100100101000001010000001000001001010000000000011000110100010001000110100010000100010011011100
00100000000001010000000100000000000011100011001000000000010001010100000100101011000010000000100000100
00000011011000000100000100100100011111010010100000000111100101101011010100100010011010000011100000100
00000100010001011010011101110000000110000101000000001100110100001100110000100001110001001101001010010
00000101000000111100011001000000000000100000100000010001100011000000010001001100001000000001110001010
00101110000011110010000001010101001010001101001000110000101000101100101101001011000011000010010101010
00000010001000011100000001000011100000000001000000000100000001001000100000010001110011001000001001000
00001000010000111011010000001000000011000001101100000000010010011000000000001100001000000101100000000
00101000001011111001000110001000001100000100100010101000000110100111100101001000000110100010101000100
10000100101010011100001000001011000110000101110011000000100011000110100000000101000101101000010001010
10000100001011000000101000110100010111100100100000111100000000000000000100010000000000110110010110100
00011100000101000010011010011000010111100100000011110000101001000101110000110110000110010000100010000
10000001000000001001010000011110001001010100001011101000100011010011110000100000001110010010000100101
01001100010000011001010010000010000000011111000000011000000001001011100000000000101010010001110101101
00010100001000011010010000010000010000000000010000001100000001001011000010011000001011100100100100011
00110000000010100000000101011010110000000001010000000001010100000010101101100010010110000010000001001
00000000000110101111000000101000100000100101000010100000000010010010100000001010010001110000000110101
10000000000101001000101000000000001001000100101111010000111000000010010000101111100000010100011010011
11000110110010000000010001001010110110001100001010110001000000100100011000011110000101001011000000010
10000000011000000001001101000100100000010001110110000010000010000000000000000001000010010010000101100
00010000011010000100000001000000100101100010001000100001000011110110101000101001001100111011000000110
00110011100100100000000100010010101101111101010001100101100010011011000000001010111100000001000110100
10001100001000000101101100111100101010010001000100100010100010001010000000010100001000010010110000001
00000100001000000001010101000100110010010000001010000001000110110000110111000000000010110000100000001
00010001000001000001001000110010100110101010000100001001001101100001011011100110000101000010000110000
00010001100001000000010000000000000001000100100010000100100000100000000000000101000010001000100011010
00100111000010100000010000000011000000010000010000001110000000000001000010000001000000000001110001110
00010001000101011011001000001100100000010001001001000010000000000001110010000000010100001000010111111
01100100000100000001100000101000000001001010000011100100111000111101000000000011000100001000010010010
01100000011100100100001000010010000000111000000000000001101101000001010001111010100001000110010000010
00000000001000000101101000001000000011010000101101100101111100110001000010000100010011000001010000100
00100010010001000100101100010011110110100101100011010001001010010110000000001011000000000000000100001
00010000001001101110000001000010010100100010010000000000010000010000000011110001001001001100011001000
00000000110100000000000110001000001110010100001000100000001011000110000000001000100101111010000000000
01010000011010000001100000000010011010101000000000000000101111011001101101000101000010010010001100110
00001110100100000111100000010000000001100010010001100010110000100101001000011101001010001000010000001
00000011010100000000100001010011000000111010100001100011000100011000000000110000110100000111000000100
00010000100000011000110110100000010010011011000100011011000010110000001000001001000000000000000101100
01011000000010000100001000100000000000000100001000100000000000100011011100000000000010001010000100010
01101101011000101001110111000101000001000000010000000001000100000010110000000000000010101010010001100
01001000010010001010100111100000001001000001000000100000011100110000010110010100101010000001001000000
00011100010000000010000010011001010000001001011100001100101110011000100000010001011000000100001010011
00000011010010000000000100011000000000001001000010000100111110000000100000000011001100011010101000000
10000000011001100000001010010000010001000000110011001000010000000001100100000111000000000000101000000
01101000000011100010100100010010000000100000111100010000011100100101011001001011010000101110001001000
00001010000101000000011000010000110010011110000101000000011001100110010000100100100101010000000000001
00010001000010001001101000001000000010000011010110110000000010010110101000000101000000000000010001100
11001001010100000000101101110001010100001100010000010100000000101000001010100000100010011100001100110
01010000000001100010010011111100100010000001010000001110101010010001110001000111000001100000111010000
00001101100000010000100010101000001000000111000000110010000001001000010110001100010010000011000010110
00000000110000001100100111001000011110010000011100010110010000001100001110110011101000000100011000000
01000010000000001110111000001010100010110100000000100010000010010100001010100000001011100000111100010
10110000101000000000000101010010100101000000000000010011010010000000110100000000010100010100101000000
10000100000110101000000100001000100100000100101010010100100010011100010000001010100001101000000010000
01010000010101001100000000001000010110000100010011000110000100111000010110000001001000011000010000000
10000000001101000001000001001011110011010110000110000011000010100010001011010100001001110000000010011
10000000010100011001100000010111000001010111110010010010000110010000000011001010000000010100000010100
00100101000001001000101100110100010010111010000000000011000101011000001101000000001010000000001010000
00011001000000101000011000000100010010000000100000000000001001011101010001101100000100010000001011001
00001010100001010010101100000100000000010001000001000000110101010000000000000100000001010000011000011
01000100000001101000000010100000000000101010100001111000100101001100011001010011100100000111100000000
00000001000000000001010001000101000000010000000000000100011000000100101000000100000010000000001001010
00001100101010000000001010101010000100010011010110011000000011000011000010101100001000100000100000000
00000011100010100101001000100000010011010001100000000100100010000010000101000100100100000011001000010
10010000010010110000000000000100000100011100001000001000000010010000110000010001000000100010010000000
10110001011000010000000000100101000001000000000110110001000111000010000001010010100010101001001001001
11000011101111000010001111011000000110100110001000001000100100100000001010110000010000001000010110001
00101110001000001110000010001011001001000010100001100001100100001000000000000000010100010101000110001
01001010000000011010100010000100001100001010110000100010100000010000010011000010000000110010100100010
01010000110000001111101000010001000100000110000110100001001001000000101000101001100010001100010001000
01011001001000001010000000001000010011000000001100010110100010000010110000000110000101010010010001000
00001101000100010000010010000000000010011000010000010100010001010000000000000000100001000001000000010
10011010111000011001011000001000110100011010111001110010100000000001001101010101100101010100001000000
10011011100010001011000100010000011100100000111001000000100010111101000110100000110100101101100001001
01011110101010001000011000000000000000010000011010010010000000010100100000000011100000101001001101000
