00011001100001100011111000100111001000000100100000101100100010100000011000000100101011100010100000011
00000110010000000110000000010000000000110001010000000000000010001001100000000110100000010110110000000
00001000100000000110010000010100100100000001010000000000000000010000101000110101000001000010000000100
00001100000110000110100100001001000001010000110010110101011010100001110000010000000100001001100110000
11000010110001100000110001001010110000000101011000001000010000000110011100100001100100100111000010000
00010010101100001000100010010100000000001000000111101001000000010100101011000001001100010011000111010
00010000100010000100100000111010100011000010001000001101000000100000001000100000001100110010011000000
00100100000001010001001001001011000000100000110000000001000010001001100000010010001000010010101000100
00100101100000100000100011010100010100001001001001100101010011100100010000000010000000101101001001101
11100010110000110000000000000001000001000000000000001110000011010000111011000101000110011000100010011
01001000001000001000101000100000000011101111000100000100001010000000000110010000000000000110001101010
10101001001011100000010010101011100010000100000001010000010101010100010011000000001000100000000111011
10101000000110000001010011100001000000000000111100100001001100000010000000001011000100011110010001001
10000000101010010011010010100001000000000000100000111000000000001000000000101010001010000100000000110
00000100100100101101000001001000010100000100011010000000010101010001010001000010110100010101101000110
10011010000100000000001001000000110110010010000001000011000100000101110110000000010001000000001000010
11101110000100000000100100101100000000000110010010000100001000001011000110101001001001000100111010100
00011100110101001101100000001101011011000000100100000000010010000100100001000110011000001101001100000
10000010000001010101001100000000010100010000000100000000100010001010000000100010100000000011000100001
00000000100101001110100101001001000000000100101000100010000010010000100001000011000001100100100000001
00000000000010000001001000100100000000010100011000100110100010001100000110010001000000010010000110010
01000001100100000000010000010000011000000001001110100110110000001001100100001000000001001000010100010
00000100010100011000000101100000001001100001001001100000000000100100010101010111001110011001100010010
11000101010000110000010000010000000101000110111100000100010010101001101000110101010011000110000001100
10010100010100010000110000000100101001001000100101001010000000000101000000111101001110000000000000101
00011010010001000100000010000100000001101000000010111010000110100000001000100000100010000110100001001
10010010010000001000101011010001000000101000000000100100100010001100000110101010010000000100000011001
00000000111110000110010101000000011100000000000101001010010101100011000000000000000001100010010000100
00101000001000000001001000001000101000000100000000001000100101000000101011101000010000000000000010000
10000000010000000010000001000100110001010010001010010011000001110110010110100110000100110110101001010
10000101001011010110001001010010110100010000100000010011100000000101010001000110001000100000101011111
10001000100010010000000011000010001100010000001100110100000000010100000100000000010000110000001010000
00100001100000011000001001000000010010110001010101110101000011000100010000110000101100001000100100111
00110111000010000000000000000010101100110000000100010100100100000001000000000000010000111010000000101
00000011110010010001100000100000000010010001111001000100001001001110001100100000101000110010110101010
00110010000000001000100000101101010000000100001000010000100000101000000001000001000100110101100001000
00010000100001000000000100000110001100110000011101000011000100000000100000000000100010000000000001011
10000000000000000000010000100000100010010000010000101000011000011101100010001001011010001111000010111
00001001000100001010000000100000010000100011100101000001001000110101001010000101000011000010000001000
10100000001010111110001000110000010110100010011000000100101010100001001000100001001011100000000100100
10111001110000101000000101000001000110010100001011111001010010001100010001000110001000000010100100001
00000011011000010010100001001010111001000100000000000010110000000000000001000000111100000110000010011
01101010001001001000100000000111000100010000010110101110110100100100110010001010100001100010001100010
00100001101100100100110001010000000001010010010100100010000000101000100011111000001001000100110010100
00000101000000001111000110000010001000011010010100010000010000010000001001110000000000010010000100110
00100100100100011001000000000001000110001000011010101110110011000110100100010000010000001010101001000
10001001001111001000000001000100000000100001000100000010100110001000101001010100011010100101000111011
01111100010000000000010000100000000110010010100010000101100100100000001000100000001001010110010000000
00000100000000001000100001001111001000010001001001000000101000010010001011010000000010100010100000000
00101110001000000100000110100000100100000000100101100000100101110001001010100001001000110100000000000
00000000000100000000001101000000010001110001011101110000010001000100000100100000100001100000000000001
01010000010000100100000100110010011100000010100011101000110011100100101001000000100111010100000011010
00000001010000010000101000001000010010100100100100000000001000000010101001000000010001100111100100000
01000000010000100001000000010000010010010010100110101000000100011100000011101100000000000010000000101
01000001110111000100111101011000100000100001100001000000111000000110001011100000100000110010001100011
00000100011000101001100000011100111001110100100010001001000010100000001000000010010001100011000000001
00010010000000111000010011010101000011001000001111000001000000000001010010110000000000000010010000000
10000000000000001111000100001001110000000001001101000010000011000000101100010110000000101101010000000
00001000001100000010000000000100100010110001011000110011010101000000000111101101000010010111100000011
00100011100000011000000000000000000010101001110010101100111000000101110001101100100001001100100000000
00001011000100000000001100010010001111000110101000101100010000000001010101000001011001110001110100001
11010000001001010000000100010010010001001001100000011110000010001001001011000000001010010000001011001
00011000000010000100111101101010101000101100011001011010000110010000000101010100100000100001001010011
00010000000000010110010110100001110100001010000100110101100000101001010000000010000111010100100000000
10011011000000101101101000111010000000001000001010010001100000010001011001101001000010001000000001011
10011000110110000110110010000100100001001000010001001010001010110100001001100000000100111001000001100
00101100100000000000000000011001000010000001000000010010001000101000010000001011000000000000000101011
00101000100110000010010000000001010011010000101011010010010000000000101011001111001001100100000110100
00010000100010000000100000001100000101010001010000010010000001000000010000010000101101010000000000010
00110000100000000110101100100011000000010000000100011110000000001001011111000100000010010000111100010
10001001000000010000011110000111001100000010100010001000000101000011110001000110010000000001010000000
10000111000000100011111001001000010000000000100001100000000000000000000010011000001010000110000001000
01001000110001000010001000010101001101000010000001000001000000001011000000000100001000001010001100000
10110001100100010101001010000010011100011001000100000001011110001000101000001111000000101100110000101
01000010000000101000111010110010001000000000000011000101001011010010010001010100011100010000000000001
00110110000001000000000000000010000101000100001101100000011000011101010000000011010010111100010000111
00000001000100010100000010000100001000110011110010001000000110000100000010000000001011010010001010001
11000001100010011100000001000000000100011011100100000100010110000011000110011100010000100000100111101
11001000010110101011100100000001100010010010000101101000010100110101000011101000100000010010010010000
01000100100010001000100000001001111010001000000001001000000100000010100000010000100100000000000100011
00100100001010000001001000000011100000010011000001100001101010000010000001100010010101000001010000110
11000101001001110000000010101000011000010100101100001010010000010011101000010010000010100000000111000
11000000011010000100001000010110101000001101010011011110100000010000000000001100001101100101001010010
01010000011001010010000000100010100000010000100100101100011101110100000001100000000111100001000101000
10000000001000000000010101101100000000101001010011101111000000000000111010000000000000001000011000000
01010001000101000101100001000000000000111100111100000010000100000000100000010100000010000000100100000
01000000011001000110000000000001000011000110000000000100001111111010100000001000000001000100111010000
10100001110001100010001000110100001000010010000101000110100011000000000000100000111010101101011000110
10010010011001101001000110000101100010100001111100100110010011101010101011100000001001000000100000000
01101001010001010000001100011000000000000001010000000000010101000000101010010011001000101001010110100
11110000000001111101001111000010011101011110101000000101001010110000010101111010000011000000000010000
01000000000000100001010000000010010000001010100001110000000000000001001000000010100101101000001100000
00010010101100000100100000001000000000000101000011010101000000000010100010110000001000101000111010010
00000010000001000000110000000001100001100100000010001010111000001001001001000100001100101101000000001
00100001111000011000011001110001001000000000110011001010010000100001001011100111010000010010001000100
00011011001010010001011100100000001110000011000101001010000010001010000001100001100000100110011100000
00010110000100101001001100011010011000101010010010010101010100010010000110100000110010000011100000100
01001001000100100101000100001010000110000000011100010000001101100010000101000000011100001001010000000
00000100111110000010011010000100000001010000000110010100000101101100001101100001110000001100001001100
00001001000100000110000010001001000001000010000011011001001010111110100101001101001010100000000000000
00110111110101001111010000100111000100100000001000101000000001000100000101000100000010000001010001010
