00110101010010010000010011010011001010011010110010010001001001011110001001000011011011001000000010011
00000001010000000000000011100000110110010100001000000001000010001000000000001100010000000001101101110
00000101100101101001100000100000000100000000111101101010010000001001110001001001000000101000000100000
00000010101100010000010001001000100110000000001100000101010101000000111001000100100010000000000101000
11000001100000001000000000000001010000100100110000000100000000000000011001000110011000000001001000010
00000000000010001000000100000000101111000011001011100000100000110000100001000010111001010000011000110
00000011000000100001101011000110000001000100010001001010100000000100010000001100001010100000000101010
00000000100000100001000101001010000100100010010000101001000010011010100110101000000000111111000001010
11100000000000001000111000000000001010000101110100011001010000110001100010000111010000001000000000000
10000101101100101001110110000100110011000001000111010001000100000000001000010010010000100001100000000
10010000000101010100000001011000001101100100000100011101001011111011000100101000000000100010100011110
01000100100001000000000001000010101000001100010000000010000000110000000010000000010100110000100100010
10110011000011010000000111100111100100000010000011010100000001100000001001000000000111100010010000100
10110000100100010100101000000110010010000000100011000100101000000001100111011000000000101010110100110
00010111000100000010100101001101011000100000000001110000011100111010000000001000001110000000100100000
11011110010100000000011000011000000111101011000000101000100100000100001010010010100000001001000000000
11000100010100010010000010101010011001000100000000000001010101000000100100000001010100110100000010010
00100000110000101011001010000100101110010100010000110000011100010100111010010100100000001010100000001
01110000011001000000000000000001010000000010100000001011000010010000100001001000100100000000000010010
00000010100100000001100001000100000001000100000000110101010100000001000010000001000001100001000000000
10010001101000000000100000100110000011011101000011000100010011001000010000010011000010010000001000110
00100000000010101010000101000000000000000001010000000010011100100110001001000100100001000000010000000
01000000010000001001000001100000100001000000100100101000101101000100010000010001000100001001010010101
00101001101000001000000001000000111010101000100000010010000110000000100001000000001000000001000010111
10011001011100101010011101001000111100011100101000000100011010111010000100110100010000000000000000010
00011000001000010010100010010000010000000001100010010010010110011100001000100100010101101000000001010
00000011000010000010110100000100010100000000000000000000100001101000001000001000001110011000100001000
10010100100100100000010001000100001110110111100000100110001000001100011000100001010100000010000000001
11110000000000001000010000000000000000001001000001011010100111110010001000110010001000010000011100000
00000000100000001000100100110001000001000000100010000111000110000000000100010101101001001010100011110
00001001000000100110000010000000000000010001000000000000010110011100100100011000000100000000110000000
00001010100000101000000000001011100000001000010111001010000000000000000110100101000101110010101001000
10010001000111000000000010100001100001010100010100000100110011000100100010000010001111000111000000000
00010001101010010101001001001000101010110001100010011101100111010010000001101000000100000010100100100
01100100001000100110100000100011001000100101000111001000001000000000011111110011100000000100010101110
00000000000110000000010000101000001000011001000000010100010000000100000101010000101010010001001101000
00000000100001100100101000101011110001000010000000110000000100010000101000100000010001010010001000011
00010100000010000010100000000001010000010101000001000001000111110100010010000100010010010010100000010
00000010010000111000101101000000000100011000010100011000000011000100110010111100000000111011000000110
11000001000001001001101000100110000010011000001011001001011000001001011010110000000000000011000000000
11010111110000100111110100000000010000010010100000011000001000101110010011010000001101100001000001000
01010101000011100000000000100000010001000010000010100010000100000010100100100000010000111111110110000
00001010000000110111100000111000000000000100011100010000010000100010001011001000010101000001001001000
00010000101001000000000000101001010000100010101000011010000010000110101100000001000010100100101000110
10100000000010100100001010000100001001000101001001000101110000010101100100010000110000100000010011111
10000011100110001010001011000101011000111001100100001000110100010100010010101000010100011100100110100
11000100001010011110101100010000011110010000000101010100000000000000000001000000000000100000010001000
00100000100000000001001000000101101010001000011011110010000010000001000010100100000000010000001000001
10000011010000001010000001000001100000101101100000011001100101000000011110001101101001000000100011010
00101010100000000000000010010000110001110011001100001010100100100011001000010001001010000001100000000
00000010010110000010100000000001001000100000000010100100100001100011000000000010000110000000000011001
00000011010000010001111000000100110101001000001000110000001100001101111001011011000010000000100100000
00000001000110000001000000100001101100111011011011011001001001001000011000110100000001000010000111011
10000000000010000000001100001000100000100110110110010100100100001100000101010000001001010000000001100
00101010100010110100011111100001100000001000100111111001000000000000101011100000000000010101011110000
00100110001000000100110000101010000000000010000110001001100011100011100001101000010110011101000001000
10110000100101100000000101100101111100000000100000111001100100011000000101000110000110000101110111110
10000000100010001000100100010010000000000101110010111000000000000000010000011000101011000100000001100
10000011000000011000010000011001010010100100010000010000000001001101000100000101011010001000000010000
11000011111001001010000101010001000100100000010000000100000110100110000110010101100000010100001100000
10010000000100101000010101000010100000110010010101011011000000000001000000011000111000000000100011000
00001000110011101001110100000000110010001010000001001100010100011110010000001110010101101100001100000
00001110001110001011100010001001010000010010000000000000100010000101110000000101000000101100000000000
00000100000110000000001010100010100010000000110000101011100000001101000000111100000011000010100100110
01000110000100110010100001110010000110010011000010011100100000000111110100000001001000100001100000000
10000000100101001000010100100000010010010010000000111100110000001101100100001000000001100000110101100
00011010010000000011001010000100001000000101000001010000111000100100110110000101010000000010100001001
11101110010010000000010100110010010110000001011000110001110000001100000000000100000001000001010111100
01000100100000001100101000000000000000000110010001010000001000011011000010001011011000000000010100001
00010101111111101000010000100100000010100111000000001110001111000000000001000100011110000000001000000
11011011010100001000000101010000000100001001001011100000000010010001100100011000100011110100000000110
00000010100001000011000101011000100000010101010000000111101000010001010000000000100000100000100010000
01101000000010000000011100000010101010000000101110001001101001000000000001000000000001000100100011000
00000000000110000011111000100000010011101000100000000111000101000000100100010101010100000010011000000
00100001000001000000111000011100101100011100000100000100110000100100110001000010100000100100101100000
00000101001110011111000000000001001000000101011101101110001001000000111101010110000000010001000110101
00000000001001000110000001000100000101110100011011100000001010000000001010001100000011001100100110001
11100010011010011000000110100000100000000000101000010011000010000011001000000000000000010001110000000
01000100100000011100101000100000010101000001100001001111101001011000000000000100011001000100000000010
01101011000010100000000000000100000000010000010100111000110000000001000000000100000011101000000100011
00000101000001011000001010000000001000100111000000000101100011010100001000100100010100101011110000010
00010000101000000000010000001000100100010001011100000000100011100000001000100011000001000011000000110
10000110101100100000001101000001110110000010000001011000000111111010010000110001001000000000000100101
00100010100100000000010010010000100010011010110100101001000011010010000110100101001010000000100100110
01000000110101111001101010100100010000011101100001000001100001010100001111000001111100010000000000000
00001000110010011100000000010010100001000000000000010000000001100010001000000010001000000110100011001
10000000010100010000100100010101010000100100011001000000001100000000000100001000110101110100000000010
01111001000001110101100000100000000000000100100000000000000100000000000001101111000001001011100001010
00000101001100000010100000000110010001010010100000010001111000100100010000000001101010101000100010000
00000011100000000100011000011010100000000000001101100001111110000001111000000100000000010100001011010
01100000100011011100010000110000010000110100010010010000010000110000000001000010100001001011101010000
01011001001101001101000100011100111001010001000110010000011000000001110010100010011001000001010000000
00001010000110111000010100010010010000000011000001001000001010100010101001101001100011000100000010001
00100000100000111100000011001010100011010000101000001011100000100111000110000110000001010000000001000
00000001010000110111001010100010000101001101000010010100101010100011100100010000000010000111000000000
00001101000100000000110000100001011000101001011001100110000100000001001111000101000010000101111000010
00001000011001000000100000000011000001111100110010000000100000000000000000010000000000000011101000100
00100010001010000011000001100011100110100001000000100110000000110101000100100010011000110010010001010
00100101000000101011000101011010111000100000101001000001000000000101001110001010010000010000010001001
00010010000000000000111001100000101010011010010010010000110000000000100101000011111011000001010000001
01000100000000110000100000111000010001001100001000110000100110010001110010001010011000000111011000100
